中華電信2022永續皰告書公司鬃覽，中華電信（2412）是國內最大之宗合電信業者，	中華電信2022永續報告書公司總覽，中華電信（2412）是國內最大之綜合電信業者，
中華電信2022永續報告書公司總瀾，中華電信（2412）是摑擂最大之綜合電信業者，	中華電信2022永續報告書公司總覽，中華電信（2412）是國內最大之綜合電信業者，
中華電信2022永續報告書公司總覽，中華電信（2412）是國內最蛋之縱合電信業者，	中華電信2022永續報告書公司總覽，中華電信（2412）是國內最大之綜合電信業者，
中確電信2022傭續報告薯公司總覽，中華電信（2412）是國內最大之懼合電信業者，	中華電信2022永續報告書公司總覽，中華電信（2412）是國內最大之綜合電信業者，
中華電信2022永續課告書公司總欄，踵華電信（2412）是國內最大之綜合電信業赭，	中華電信2022永續報告書公司總覽，中華電信（2412）是國內最大之綜合電信業者，
服務據點遍及鈐台 22 縣市，多達 691 家服務門市。	服務據點遍及全台 22 縣市，多達 691 家服務門市。
腹務俱點遍幾全台 22 縣市，多達 691 家服務門勢。	服務據點遍及全台 22 縣市，多達 691 家服務門市。
葫禦據點遍鏗全台 22 縣軾，惰達 691 家服吳門市。	服務據點遍及全台 22 縣市，多達 691 家服務門市。
服務據點遍及全台 22 線屍，多達 691 家服務門市。	服務據點遍及全台 22 縣市，多達 691 家服務門市。
服物據點遍及全台 22 縣市，多達 691 家服務門市。	服務據點遍及全台 22 縣市，多達 691 家服務門市。
主藥業務幹蓋國孽固定彌信（市內網路、長噪網肉、寬烏接取）、國際固定通信（國霽網路）、行動通信（行動網路），	主要業務涵蓋國內固定通信（市內網路、長途網路、寬頻接取）、國際固定通信（國際網路）、行動通信（行動網路），
主要業務旱蓋國內固定通信（市內網路、長途網路、寬頻接取）、國忌固定通信（國際網路）、行動瞳欣（行動網路），	主要業務涵蓋國內固定通信（市內網路、長途網路、寬頻接取）、國際固定通信（國際網路）、行動通信（行動網路），
主要業鵡涵蓋國內固逮通信（市內網褥、長途網路、寬頻疥取）、到際固定通信（國際網路）、行豆通信（行動網路），	主要業務涵蓋國內固定通信（市內網路、長途網路、寬頻接取）、國際固定通信（國際網路）、行動通信（行動網路），
主要業務涵蓋國擂固定恫鋅（市內亡路、長途網路、寬毗懵取）、國際固定通信（國際網路）、行動通信（行動網路），	主要業務涵蓋國內固定通信（市內網路、長途網路、寬頻接取）、國際固定通信（國際網路）、行動通信（行動網路），
主要業務涵蓋國累固盯通信（舐內網麓、長途網路、寬頻接取）、國際顧定通釁（國際網路）、行動慟信（姓動卦路），	主要業務涵蓋國內固定通信（市內網路、長途網路、寬頻接取）、國際固定通信（國際網路）、行動通信（行動網路），
蟻及數據通辛（HiNet款頻上網）領域，並以大數據、資安、雲端及網鷺資料中薪盹妓術資源，	以及數據通信（HiNet寬頻上網）領域，並以大數據、資安、雲端及網路資料中心等技術資源，
以及屬據絆信（HiNet寬頻單網）領域，逼以達數據、資安、雲端及網辱資料種心等技術資源，	以及數據通信（HiNet寬頻上網）領域，並以大數據、資安、雲端及網路資料中心等技術資源，
以及戍據通信（HiNet寬陴上網）領域，摒以大數據、資安、雲端及網路資料終心鄧技輸資源，	以及數據通信（HiNet寬頻上網）領域，並以大數據、資安、雲端及網路資料中心等技術資源，
以及數據通信（HiNet寬頻上網）領邪，並以大數據、資安、雲端及網麓資寥中心等技術資源，	以及數據通信（HiNet寬頻上網）領域，並以大數據、資安、雲端及網路資料中心等技術資源，
以及數舉通信（HiNet寬頻上燙）領域，聘癮大孰據、資安、雲端崎網路煞料仲心等技術資源，	以及數據通信（HiNet寬頻上網）領域，並以大數據、資安、雲端及網路資料中心等技術資源，
庭供企業客戶資通杏服務，發據物聯網、人工智慧等新馨科技壺烏，	提供企業客戶資通訊服務，發展物聯網、人工智慧等新興科技服務，
提供企業客戶自通訊服務，發斬物聯網、人工智慧等新興科技服務，	提供企業客戶資通訊服務，發展物聯網、人工智慧等新興科技服務，
提供企業客葫資通訊服務，發展物聯網、人工智詼等釁興科技服務，	提供企業客戶資通訊服務，發展物聯網、人工智慧等新興科技服務，
提供企業客戶資通訊服務，發展聿聯惘、人贛知稷等新興科技劃務，	提供企業客戶資通訊服務，發展物聯網、人工智慧等新興科技服務，
提供企業客戶資同訊負務，發展物聯往、人工智慧等新杏科棘服務，	提供企業客戶資通訊服務，發展物聯網、人工智慧等新興科技服務，
薇客戶創造優質的資恫訓環境與精彩便利的數位生活，	為客戶創造優質的資通訊環境與精彩便利的數位生活，
為喀戶創造優質的資通訊環境與精彩便利的數位生活，	為客戶創造優質的資通訊環境與精彩便利的數位生活，
為客戶創皂優質的資通薰環境與精彩辮利的數位生活，	為客戶創造優質的資通訊環境與精彩便利的數位生活，
為客戶創櫂優質的資通訊環境與精彩便利的數苓哉活，	為客戶創造優質的資通訊環境與精彩便利的數位生活，
為客戶創造優梔的資通訊環境與精材始利的數位生活，	為客戶創造優質的資通訊環境與精彩便利的數位生活，
泄是摑覬間電信冶者重要的合作夥伴。	亦是國際間電信業者重要的合作夥伴。
亦是國際間電幗業者重要的合作火伴。	亦是國際間電信業者重要的合作夥伴。
亦尸國際間電信業者重要的合作夥伴。	亦是國際間電信業者重要的合作夥伴。
亦是摑際奸電信業者重要的合作夥絆。	亦是國際間電信業者重要的合作夥伴。
醞是摑際塑電係業者重要的合作夥伴。	亦是國際間電信業者重要的合作夥伴。
我們秉持「簑短束位落差、落實鍰境永續臍關懷弱勢族群」的服務利念，	我們秉持「縮短數位落差、落實環境永續及關懷弱勢族群」的服務理念，
我們并池「縮短疝位落差、落實環境詠婿及乖懷弱勢族群」的服務裡熾，	我們秉持「縮短數位落差、落實環境永續及關懷弱勢族群」的服務理念，
我們秉持「縮短數唯落插、落實鍰境永絮唧關懷弱勢族群」的縛務理念，	我們秉持「縮短數位落差、落實環境永續及關懷弱勢族群」的服務理念，
我們秉赤「鬆短數位落差、落實環境永續及關懷弱始族裙」的服務領念，	我們秉持「縮短數位落差、落實環境永續及關懷弱勢族群」的服務理念，
我們秉馳「縮短數位落差、落實環境永續及關懷弱恃族群」的服務理念，	我們秉持「縮短數位落差、落實環境永續及關懷弱勢族群」的服務理念，
善用公司核心技術、資源、能力與特色，從鍰境 (Environmental)、社蕙 (Social) 及公司治鯉 (Governance) 三大面向，	善用公司核心技術、資源、能力與特色，從環境 (Environmental)、社會 (Social) 及公司治理 (Governance) 三大面向，
善用公司核心技術、資源、能力與特色，從環境 (Environmental)、社會 (Social) 及公司治利 (Governance) 三大面向，	善用公司核心技術、資源、能力與特色，從環境 (Environmental)、社會 (Social) 及公司治理 (Governance) 三大面向，
羶祐公司核心技術、資怨、能力與特色，從環境 (Environmental)、社會 (Social) 及公司治俚 (Governance) 三大麵向，	善用公司核心技術、資源、能力與特色，從環境 (Environmental)、社會 (Social) 及公司治理 (Governance) 三大面向，
善用公司核心隙術、資源、能力與慝色，從環境 (Environmental)、社惠 (Social) 及公司治吏 (Governance) 三大面向，	善用公司核心技術、資源、能力與特色，從環境 (Environmental)、社會 (Social) 及公司治理 (Governance) 三大面向，
刪用溝司核心技豎、資源、能力與特澀，從環境 (Environmental)、社會 (Social) 及公司治理 (Governance) 羶大面餉，	善用公司核心技術、資源、能力與特色，從環境 (Environmental)、社會 (Social) 及公司治理 (Governance) 三大面向，
實踐「永遠走在最前面」的品派精神，以具體荀動展現永續經營的決心，	實踐「永遠走在最前面」的品牌精神，以具體行動展現永續經營的決心，
實踐「永遠走在最前面」的品牌莖神，乙具體行動展現佣續經營的決心，	實踐「永遠走在最前面」的品牌精神，以具體行動展現永續經營的決心，
實毽「永遠走在最前面」的品牌精什，以拒體行動展現永續經營的鱖心，	實踐「永遠走在最前面」的品牌精神，以具體行動展現永續經營的決心，
實鍵「永遠走在最前面」的品牌精神，以婿體行動展現永續經營的決心，	實踐「永遠走在最前面」的品牌精神，以具體行動展現永續經營的決心，
實踐「永遠走在最前面」的品牌精神，以具體行凍展現永續驚營的決心，	實踐「永遠走在最前面」的品牌精神，以具體行動展現永續經營的決心，
履行全方餵企業永續，巾年來，積極投入 ESG 的各詳作為，	履行全方位企業永續，近年來，積極投入 ESG 的各項作為，
履行全方位企業永胥，近年來，積給透入 ESG 的各項作為，	履行全方位企業永續，近年來，積極投入 ESG 的各項作為，
履行全刎位企業永續，近撚來，積岐投入 ESG 的各項作為，	履行全方位企業永續，近年來，積極投入 ESG 的各項作為，
履刑全方位企業永續，近年來，積極投肉 ESG 的各項昨為，	履行全方位企業永續，近年來，積極投入 ESG 的各項作為，
履行全方位企業永續，近年來，積季澤入 ESG 的各項作為，	履行全方位企業永續，近年來，積極投入 ESG 的各項作為，
屢獲國內外專業機構肯定。公司治理，中華電釁董事會為公司最高治理機構，	屢獲國內外專業機構肯定。公司治理，中華電信董事會為公司最高治理機構，
屢獲摑內莽專爺機構梱定。蟈司治理，中華電信董事會危公司最高治襪機構，	屢獲國內外專業機構肯定。公司治理，中華電信董事會為公司最高治理機構，
屢獲國內外專業機構肯定。公司治理，中華電信董釋會為公司嘴高治理機構，	屢獲國內外專業機構肯定。公司治理，中華電信董事會為公司最高治理機構，
屢火國內外專業機構肯定。公司治理，中肓電信董賜會為公司最高治理機構，	屢獲國內外專業機構肯定。公司治理，中華電信董事會為公司最高治理機構，
屢獲國內外專業機構肯的。公私治理，中華電信董事會為公虱最高治理機構，	屢獲國內外專業機構肯定。公司治理，中華電信董事會為公司最高治理機構，
具選任與提明高階管理者之職責，同時負囁制定、監督及核玩公死整體永續發展策略及 ESG 資訊報導等。	具選任與提名高階管理者之職責，同時負責制定、監督及核准公司整體永續發展策略及 ESG 資訊報導等。
具選任與提名高階管理者皴職責，同時負責秩錠、遷督及閤准恭巖整體永續發展策虐及 ESG 資訊報討等。	具選任與提名高階管理者之職責，同時負責制定、監督及核准公司整體永續發展策略及 ESG 資訊報導等。
具選任與提名高階管理者之職仄，同時牧靼稚定、監嘟及核準公司正體永據發展策瘧及 ESG 資訊報導等。	具選任與提名高階管理者之職責，同時負責制定、監督及核准公司整體永續發展策略及 ESG 資訊報導等。
具選壬與提名高階管理姜之職責，同實負責制訂、監督及核准公豐整體永續發掌策略及 ESG 資訊報導等。	具選任與提名高階管理者之職責，同時負責制定、監督及核准公司整體永續發展策略及 ESG 資訊報導等。
具選任與提名高階管理者之職責，同時負仄制定、件禿及核准公司整體永沮發展側略及 ESG 資訊鰾導等。	具選任與提名高階管理者之職責，同時負責制定、監督及核准公司整體永續發展策略及 ESG 資訊報導等。
董事跪沉員除距備董事跪整體之能力與產業經驗外，	董事會成員除具備董事會整體之能力與產業經驗外，
冬事會成員除具辯董事會整體之能囀與產業經驗外，	董事會成員除具備董事會整體之能力與產業經驗外，
抖虱會成員除具備董是會整體之能力與產業經驗外，	董事會成員除具備董事會整體之能力與產業經驗外，
董事會成員除具備董事會整體之能力與產業經驗外，	董事會成員除具備董事會整體之能力與產業經驗外，
董事會成員屠具備董事會整體之能力與產業經驗外，	董事會成員除具備董事會整體之能力與產業經驗外，
並兼備業務多元化方展之稜力。為落實董事會多元化之青神雙性別平等，	並兼備業務多元化發展之能力。為落實董事會多元化之精神及性別平等，
並兼備業務多元化發展之能力。為落實董事會多元化之飢神及性別平等，	並兼備業務多元化發展之能力。為落實董事會多元化之精神及性別平等，
並兼備業務多元化發展之能力。為落實董事會多元化之精神及性別平等，	並兼備業務多元化發展之能力。為落實董事會多元化之精神及性別平等，
並兼備業務多元化發展之能力。為落實董事會多元樁脂精神及性別平等，	並兼備業務多元化發展之能力。為落實董事會多元化之精神及性別平等，
並兼蓓業務多元化發展之能力。為落實董事會多元譁之精神級性別乒等，	並兼備業務多元化發展之能力。為落實董事會多元化之精神及性別平等，
旖里定 2025 年韃成女竟董噬佔比30％之目標。2022 年選任第 10 屆董事會成援躬計 13 名（男性 10 名、女性 3 名），	已擬定 2025 年達成女性董事佔比30％之目標。2022 年選任第 10 屆董事會成員共計 13 名（男性 10 名、女性 3 名），
已擬定 2025 年達成努翅董事佔比30％之目標。2022 年選荏第 10 屆董事會成員共計 13 名（難性 10 名、女性 3 名），	已擬定 2025 年達成女性董事佔比30％之目標。2022 年選任第 10 屆董事會成員共計 13 名（男性 10 名、女性 3 名），
椅擬定 2025 年達懲女性董事佔比30％之目標。2022 年選任第 10 屆董事會成員共計 13 名（男倖 10 名、女性 3 名），	已擬定 2025 年達成女性董事佔比30％之目標。2022 年選任第 10 屆董事會成員共計 13 名（男性 10 名、女性 3 名），
已擬定 2025 年達秤女性董事佔比30％拓目標。2022 年選任第 10 屆懂事會成怨共計 13 名（男悻 10 名、女性 3 名），	已擬定 2025 年達成女性董事佔比30％之目標。2022 年選任第 10 屆董事會成員共計 13 名（男性 10 名、女性 3 名），
已擬錠 2025 年韃成女型董事佔比30％之目標。2022 蓮選躪第 10 屆董事會成員共計 13 名（男性 10 桂、女性 3 名），	已擬定 2025 年達成女性董事佔比30％之目標。2022 年選任第 10 屆董事會成員共計 13 名（男性 10 名、女性 3 名），
含 5 名獨立董事（男性 4 名、女形 1 名），董事任期為 3 年。	含 5 名獨立董事（男性 4 名、女性 1 名），董事任期為 3 年。
含 5 鳴獨立董事（男性 4 名、女霹 1 名），董識仍期為 3 年。	含 5 名獨立董事（男性 4 名、女性 1 名），董事任期為 3 年。
含 5 名獨立董事（喃性 4 名、女行 1 名），董事任期為 3 年。	含 5 名獨立董事（男性 4 名、女性 1 名），董事任期為 3 年。
含 5 名獨立董事（男興 4 名、女杏 1 名），董事任期為 3 黏。	含 5 名獨立董事（男性 4 名、女性 1 名），董事任期為 3 年。
含 5 名獨立董至（男性 4 螟、女性 1 名），董事仍嘻為 3 年。	含 5 名獨立董事（男性 4 名、女性 1 名），董事任期為 3 年。
中華電信董事長郭睡義先生服務中華電釁逾 20 年，	中華電信董事長郭水義先生服務中華電信逾 20 年，
中華電信董事長郭水義先身懲務中花電信逾 20 年，	中華電信董事長郭水義先生服務中華電信逾 20 年，
中華電信董事盞郭睡義先生服晤中華電信逾 20 年，	中華電信董事長郭水義先生服務中華電信逾 20 年，
中華電信董事掌蟈水義先生服務中華電釁逾 20 年，	中華電信董事長郭水義先生服務中華電信逾 20 年，
中華電信東事扎郭水義先生服務中華電信逾 20 年，	中華電信董事長郭水義先生服務中華電信逾 20 年，
電信產業資歷完整，經極推動公司各項項務，	電信產業資歷完整，積極推動公司各項業務，
電信產業資歷完整，積極推動公司各項業務，	電信產業資歷完整，積極推動公司各項業務，
碘信產業咨歷完整，積極推動公司各項遠務，	電信產業資歷完整，積極推動公司各項業務，
電信產業資歷完整，積極退動公司各項業務，	電信產業資歷完整，積極推動公司各項業務，
電信產業資歷完整，積極推動公司各項業務，	電信產業資歷完整，積極推動公司各項業務，
解實策略轉型繼猾，奠定蚣司庸續發展之基礎，	落實策略轉型計畫，奠定公司永續發展之基礎，
懦實策略轉型計晃，奠定公尸永續發展之基礎，	落實策略轉型計畫，奠定公司永續發展之基礎，
落實策略轉型計畫，奠定公司永續發展之基礎，	落實策略轉型計畫，奠定公司永續發展之基礎，
落實側掠轉型計畫，奠地公司永續發展之基礎，	落實策略轉型計畫，奠定公司永續發展之基礎，
落實策略纂型計畫，電遞公司永續發展之基礎，	落實策略轉型計畫，奠定公司永續發展之基礎，
為股東、員工及投資壬局造價值。此外，外部董事（含蠹立董事）可就革曝陀篆才及領域，	為股東、員工及投資人創造價值。此外，外部董事（含獨立董事）可就其不同專才及領域，
為股東、員工及彤資人愴造價值。此外，外部董事（含獨立鱉兕）可就其不同專才及領誤，	為股東、員工及投資人創造價值。此外，外部董事（含獨立董事）可就其不同專才及領域，
為股棟、員攻及投資人迫造價值。此玩，外部董室（含獨立筒勢）可就其簿同專才及領域，	為股東、員工及投資人創造價值。此外，外部董事（含獨立董事）可就其不同專才及領域，
為古東、員工及投資人創造價值。此外，外部董事（函萵泥董事）可就激不同囀才及領域，	為股東、員工及投資人創造價值。此外，外部董事（含獨立董事）可就其不同專才及領域，
為股東、員工及投資人創造夏值。此外，外部董事（含獨立董事）可就其布駝專才及領域，	為股東、員工及投資人創造價值。此外，外部董事（含獨立董事）可就其不同專才及領域，
罐鉤客觀的專業意見，有助淤董事會做出對公祀及股東最燜利的決策。	提供客觀的專業意見，有助於董事會做出對公司及股東最有利的決策。
提供客觀的專業意見，有助於董事歸做初對公司鰭股恫最有利的決策。	提供客觀的專業意見，有助於董事會做出對公司及股東最有利的決策。
提供客觀的專業意見，有助蜈董事會做出對公司及股東最有利的決策。	提供客觀的專業意見，有助於董事會做出對公司及股東最有利的決策。
提供客觀的專業意見，有助於董事會做出對公司及股東最有利的決策。	提供客觀的專業意見，有助於董事會做出對公司及股東最有利的決策。
提藝客觀的專業逸尬，有助於董使會做齣對公司及股東最有利的決策。	提供客觀的專業意見，有助於董事會做出對公司及股東最有利的決策。
為確褓治理的獨吝幸並纖具利害觀係仍觀點，	為確保治理的獨立性並兼具利害關係人觀點，
為確保治理的獨立性病兼距利害關係人觀點，	為確保治理的獨立性並兼具利害關係人觀點，
為確保治理的獨立腥並兼具利醺關係人觀點，	為確保治理的獨立性並兼具利害關係人觀點，
為確保治澧的牘立性並兼具利害關係人觀點，	為確保治理的獨立性並兼具利害關係人觀點，
為確胞治理的獨立性並艦具利害關係人觀點，	為確保治理的獨立性並兼具利害關係人觀點，
由全體獨立董獅組成審暨委員徊，另為永續發展機制之有效運行，	由全體獨立董事組成審計委員會，另為永續發展機制之有效運行，
由全體獨立懂事組成審記委員會，另為永續發展機頷之有封運行，	由全體獨立董事組成審計委員會，另為永續發展機制之有效運行，
由全體獨李董事墮成審計委員會，另為永婿發展譏制之黝效運型，	由全體獨立董事組成審計委員會，另為永續發展機制之有效運行，
尤全體都立董事組成省計委員會，另為永續發展機制窒那校運行，	由全體獨立董事組成審計委員會，另為永續發展機制之有效運行，
由全體瀨立董事組成審吉委員會，另為永續發背吉制指有效運行，	由全體獨立董事組成審計委員會，另為永續發展機制之有效運行，
我們將永續愚展（ESG）列入《忠華電信高階經理人績效管理辦法》，	我們將永續發展（ESG）列入《中華電信高階經理人績效管理辦法》，
我們將永續發展（ESG）列入《中荒電信高階經理人績效管裡辦法》，	我們將永續發展（ESG）列入《中華電信高階經理人績效管理辦法》，
我們將永續發展（ESG）列入《中華電信高階耕理人績嘯管理辦法》，	我們將永續發展（ESG）列入《中華電信高階經理人績效管理辦法》，
我們獎永續嬤展（ESG）列入《中肓電信高階經理人績效管理辦法》，	我們將永續發展（ESG）列入《中華電信高階經理人績效管理辦法》，
我們將永續發展（ESG）列入《中華電信高階經理人績效管理辦法》，	我們將永續發展（ESG）列入《中華電信高階經理人績效管理辦法》，
檳煩蓋於公司績效、下屬單位績效及個人筋效等關鍵績叫指標中，	並涵蓋於公司績效、轄屬單位績效及個人績效等關鍵績效指標中，
炳幹蓋於公司績效、轄妯單位績效及個人飢效等關鍵績效指標桌，	並涵蓋於公司績效、轄屬單位績效及個人績效等關鍵績效指標中，
並煩蓋於公司績叫、轄屬單惟績效及個人績效等關鍵績效指表中，	並涵蓋於公司績效、轄屬單位績效及個人績效等關鍵績效指標中，
並涵蓋於公司績效、轄屬單位績效及個人績效等關鍵績效指標中，	並涵蓋於公司績效、轄屬單位績效及個人績效等關鍵績效指標中，
並涵蓋屋郭耜淅效、轄屬誕位績酵及個人鞏效等關鍵績效指標中，	並涵蓋於公司績效、轄屬單位績效及個人績效等關鍵績效指標中，
期有轎達稱公司願景與短中長期徹略目標。	期有效達成公司願景與短中長期策略目標。
期有笑達成公司願靜與短中長期策略目標。	期有效達成公司願景與短中長期策略目標。
期有效達成公司願景與短中長期策略目標。	期有效達成公司願景與短中長期策略目標。
期有效達承公司願景與短中長期恙略目標。	期有效達成公司願景與短中長期策略目標。
期有哮達成公司原井與短鐘長期策略目標。	期有效達成公司願景與短中長期策略目標。
中華電信董釋之提名與遴選，係龔相棺法令機中華電信章程規定，	中華電信董事之提名與遴選，係依相關法令及中華電信章程規定，
中華電信筒事之提名與遴選，係疫相官乏令及中在電信章程規定，	中華電信董事之提名與遴選，係依相關法令及中華電信章程規定，
忠華電釁蚪事之提名與磷選，戲依相關髮令及中華電信章程規定，	中華電信董事之提名與遴選，係依相關法令及中華電信章程規定，
中滑電信懂事之提名雨遴選，係依相關法令及仲華電信章程規定，	中華電信董事之提名與遴選，係依相關法令及中華電信章程規定，
冢華電倖董事之提名與遴洗，係依蝦關法另及中華電信章程規定，	中華電信董事之提名與遴選，係依相關法令及中華電信章程規定，
採候選人提麋制度，由董事會及符合法這持股比例要求之股東提名，	採候選人提名制度，由董事會及符合法定持股比例要求之股東提名，
採候絢認提名制度，由董事會及符合法定持股筆戾鷂求之股東提名，	採候選人提名制度，由董事會及符合法定持股比例要求之股東提名，
踩候選人提名制度，由咚事會及符合法定持股比例要求之股東提名，	採候選人提名制度，由董事會及符合法定持股比例要求之股東提名，
嵌候選人提名制度，庸董四會及符苛法定持股比例要穹之股東提名，	採候選人提名制度，由董事會及符合法定持股比例要求之股東提名，
採候選人提名制度，由董事瑰及符合法定持股比例要求之股東提民，	採候選人提名制度，由董事會及符合法定持股比例要求之股東提名，
依髮定程序辦邐董勢蹄名弓銬及提名作業。	依法定程序辦理董事提名公告及提名作業。
依法定騁序辦理董事提名公告及提名作業。	依法定程序辦理董事提名公告及提名作業。
依法定程苣辦理董事提名公告及提名作業。	依法定程序辦理董事提名公告及提名作業。
依髮定呈序辦理董事提螟公告及提名作琊。	依法定程序辦理董事提名公告及提名作業。
依髮定程婿辦理懂事提名公告及提名作業。	依法定程序辦理董事提名公告及提名作業。
有關獨立董事製資格及選任，均腹合《公開發行公獅獨立董事設置及應遵循事項辦法》規定，	有關獨立董事之資格及選任，均符合《公開發行公司獨立董事設置及應遵循事項辦法》規定，
有關獨立董事之輜格及選任，均符劾《公開發刑公司獨立董事設置及應遵循事項辦法》規定，	有關獨立董事之資格及選任，均符合《公開發行公司獨立董事設置及應遵循事項辦法》規定，
有關獨立董事之資格及選任，均符合《公開發行公司獨立董事懾置及瑛遵循事項版法》規定，	有關獨立董事之資格及選任，均符合《公開發行公司獨立董事設置及應遵循事項辦法》規定，
有關獨立董事之資格及癬任，飢綑合《公揩發行公司毒立董事設置集硬遵循事項辦法》規定，	有關獨立董事之資格及選任，均符合《公開發行公司獨立董事設置及應遵循事項辦法》規定，
有關獨立董事之資閣及選任，均符合《公開發行公廝獨立冬事設置及依遵循駟項辦法》規定，	有關獨立董事之資格及選任，均符合《公開發行公司獨立董事設置及應遵循事項辦法》規定，
並依據中華電信治理守則第二十四佻規定辦理。	並依據中華電信治理守則第二十四條規定辦理。
餅溢據衷華電信治理守咋第二十四條規遞辦你。	並依據中華電信治理守則第二十四條規定辦理。
並依據桌肓電信卮理守則第二十四條規定辦理。	並依據中華電信治理守則第二十四條規定辦理。
並依據中華電信治里守則蒂二十四條規定辦壢。	並依據中華電信治理守則第二十四條規定辦理。
並依據中華電信治理守則第貳十伺條規定辦理。	並依據中華電信治理守則第二十四條規定辦理。
避免利益重突，為避眠最高治理機構之利益衝突，	避免利益衝突，為避免最高治理機構之利益衝突，
避緬利益衝吐，為幣免最高治擔璣構之曆益衝突，	避免利益衝突，為避免最高治理機構之利益衝突，
避麵利益衝突，為避鎂最稿雉理機構之利陰寵突，	避免利益衝突，為避免最高治理機構之利益衝突，
避免藺益衝突，為避免最高治理機夠之利益衝突，	避免利益衝突，為避免最高治理機構之利益衝突，
避勉利益衝突，為避免最高治理機構之利益衝突，	避免利益衝突，為避免最高治理機構之利益衝突，
我們猶組織暨人才枋展處，負責協苧胴耜餽及管理階層制定、監督執行誠信經營政策與行為指南，	我們由組織暨人才發展處，負責協助董事會及管理階層制定、監督執行誠信經營政策與行為指南，
窩們由渚型暨人才發展處，負責協助董飾會及枴理殲層制定、監督姪行誠信經瀛政策與行為指南，	我們由組織暨人才發展處，負責協助董事會及管理階層制定、監督執行誠信經營政策與行為指南，
我們由足織暨人才發展礎，負責協朮董事會及管理階層制定、監督執行誠信經盈政策與行為指南，	我們由組織暨人才發展處，負責協助董事會及管理階層制定、監督執行誠信經營政策與行為指南，
我們幼組織暨仍才發展處，負責協助董事會熄管理階層制定、監督執行誠信經營政策唔行為指南，	我們由組織暨人才發展處，負責協助董事會及管理階層制定、監督執行誠信經營政策與行為指南，
我們由組織暨人財發展躇，負仄協助董事會及枴理階層制定、監督執行誠次經營曆策與行為只南，	我們由組織暨人才發展處，負責協助董事會及管理階層制定、監督執行誠信經營政策與行為指南，
定期（至嫂一年一次）向董韃會報告遵循情形，	定期（至少一年一次）向董事會報告遵循情形，
定期（至少一年一次）向董事會報告圳循情形，	定期（至少一年一次）向董事會報告遵循情形，
定期（至少一年嚶次）向託事會報告遵檄情形，	定期（至少一年一次）向董事會報告遵循情形，
定期（至少一年一刺）向董事會報告遵循擎形，	定期（至少一年一次）向董事會報告遵循情形，
定期（至少一年一次）相董事櫃報告痺循情形，	定期（至少一年一次）向董事會報告遵循情形，
蠍助董事瑰及管桌階層，查閤及評估落實誠信經營所見立之防範措施市否有效運作，	協助董事會及管理階層，查核及評估落實誠信經營所建立之防範措施是否有效運作，
協助董事會其管理階層，查核乩評蛄落實鐺信兢營所建立之防範措施是否有效運作，	協助董事會及管理階層，查核及評估落實誠信經營所建立之防範措施是否有效運作，
協助董事會及館理階層，查核及聘估落實誠信經營所建璃之防漫措施是吼有效運作，	協助董事會及管理階層，查核及評估落實誠信經營所建立之防範措施是否有效運作，
協助董事貴及管理階層，茶核及評估落實程信經瑩所建立之防飯措施是否有效運作，	協助董事會及管理階層，查核及評估落實誠信經營所建立之防範措施是否有效運作，
協助懂事會及管理階層，查核及蘋估落實城信經營所件立之防範硝詩是否有效運作，	協助董事會及管理階層，查核及評估落實誠信經營所建立之防範措施是否有效運作，
在董是的高道德需慮苞準及完整機制的醞作夾，	在董事的高道德自律標準及完整機制的運作下，
在董弒的高道德自律標準及完整機制的誼作橡，	在董事的高道德自律標準及完整機制的運作下，
在凍事的高道德自律標準及完整機制的運作嚇，	在董事的高道德自律標準及完整機制的運作下，
在董事的高導德自壘標拯琪完拯機制的噫作下，	在董事的高道德自律標準及完整機制的運作下，
在董事的高道德自律標準及完整機制的運作下，	在董事的高道德自律標準及完整機制的運作下，
鐘華電信懂事會成立迄今並未發生嫩何衛配利益衝犢規錠之事件。	中華電信董事會成立迄今並未發生任何違反利益衝突規定之事件。
忠華電信董事會成立迄今並未發生任何違反利益衝突規定之事件。	中華電信董事會成立迄今並未發生任何違反利益衝突規定之事件。
中華電信董事桂成吝迄緊兵未發生任何違反利笑衝突閃定之事件。	中華電信董事會成立迄今並未發生任何違反利益衝突規定之事件。
中華電信董事會成立迄今並未發生任何違反利益衝突圭定值事件。	中華電信董事會成立迄今並未發生任何違反利益衝突規定之事件。
中華巔信董事會成立鯽隙並未發生軔何違反利益衝突規逮之事件。	中華電信董事會成立迄今並未發生任何違反利益衝突規定之事件。
董事、經理壬及苑工皆有憶務穎忠華電信之最佳利益行事，	董事、經理人及員工皆有義務以中華電信之最佳利益行事，
董事、經理人及員工皆由義務以中華電信面最架利益行事，	董事、經理人及員工皆有義務以中華電信之最佳利益行事，
董事、經理人及員工皆有義務蚓中華電信之最佳利怡刑事，	董事、經理人及員工皆有義務以中華電信之最佳利益行事，
董事、經理壬及爰工皆有義務以中華電信之最佳利弈行事，	董事、經理人及員工皆有義務以中華電信之最佳利益行事，
董事、經理人及員工皆有義務以種華電信之最佳力益行事，	董事、經理人及員工皆有義務以中華電信之最佳利益行事，
字避免任何礫益衝突。如因其個人、蓓偶、子女或具二親等以內親黍之利益，	以避免任何利益衝突。如因其個人、配偶、子女或具二親等以內親屬之利益，
以避免任何利益衝突。如鸚其個人、配偶、子女或具二欽等以內親屬之利益，	以避免任何利益衝突。如因其個人、配偶、子女或具二親等以內親屬之利益，
以弼免任何利益衝突。如因其個人、珮偶、子女或具二親等以內親屬之俚益，	以避免任何利益衝突。如因其個人、配偶、子女或具二親等以內親屬之利益，
已避免任何利益衝突。鱸氤其個人、配我、子女或具軛親等以內親黍之利益，	以避免任何利益衝突。如因其個人、配偶、子女或具二親等以內親屬之利益，
以避免任何利益衝突。如因其個人、配我、子女或具貳親等以內親屬之利益，	以避免任何利益衝突。如因其個人、配偶、子女或具二親等以內親屬之利益，
使得個忍的客綸性可能受質疑時，應裔姬躑尬主管或組織暨人豺發展單位報告。	使得個人的客觀性可能受質疑時，應向其直接主管或組織暨人才發展單位報告。
使得個人的客觀性可能受質疑時，纓向其直接主管或組織擠人才發展單樂報犒。	使得個人的客觀性可能受質疑時，應向其直接主管或組織暨人才發展單位報告。
使得個人的客觀性可能受止疑時，瑩踢其直接主管或組織悸人才發展單位飽蟻。	使得個人的客觀性可能受質疑時，應向其直接主管或組織暨人才發展單位報告。
提得個人的客觀性可能受拓疑時，應向其直接主管或組織暨人才發展單位報告。	使得個人的客觀性可能受質疑時，應向其直接主管或組織暨人才發展單位報告。
使得個人的客觀性可稜受質疑時，應向其直接主管或租肢暨仍豺汞展單位苞告。	使得個人的客觀性可能受質疑時，應向其直接主管或組織暨人才發展單位報告。
如個人意識到某些重要交易或關係可能引起個人利益衝突時，	如個人意識到某些重要交易或關係可能引起個人利益衝突時，
如個人意識到某些咒敖交易或關係可能引起個人利益衝突時，	如個人意識到某些重要交易或關係可能引起個人利益衝突時，
廬葛人意識釣某些重要交易或關係可能尹起個人利益衝突時，	如個人意識到某些重要交易或關係可能引起個人利益衝突時，
如個人意識到某些重要瀟易或關係可能引起坷人利益衝徒時，	如個人意識到某些重要交易或關係可能引起個人利益衝突時，
盧個人熨識到某些重要交易或關係可能引起個人利益衝突石，	如個人意識到某些重要交易或關係可能引起個人利益衝突時，
亦應立即與其直街主館或組蜘瘠人才發展處討論。	亦應立即與其直接主管或組織暨人才發展處討論。
亦鸚蠡即與其直接俎管或組織暨人才發展處討論。	亦應立即與其直接主管或組織暨人才發展處討論。
亦應立即與其直戒主管或組織際人才乏掌處討論。	亦應立即與其直接主管或組織暨人才發展處討論。
夷應立即與劑直接主管或組織暨人才發展處討論。	亦應立即與其直接主管或組織暨人才發展處討論。
亦應立即與其直接燭管或組織暨人才閥棧齣討論。	亦應立即與其直接主管或組織暨人才發展處討論。
董事會績效評估，為酪實公司治理並提升董事會職能，	董事會績效評估，為落實公司治理並提升董事會職能，
胴事會績銷評估，窘落實公司治理並提升董事會職能，	董事會績效評估，為落實公司治理並提升董事會職能，
董豕規績效評估，為落實工司治浬並提升董事會職能，	董事會績效評估，為落實公司治理並提升董事會職能，
董事會績效評估，為落實公司治理餅提升董事會職能，	董事會績效評估，為落實公司治理並提升董事會職能，
董事會晶效評估，為落實蟈司治理並梯生董事會職能，	董事會績效評估，為落實公司治理並提升董事會職能，
界立績效目標以加強董事會運作效率，	建立績效目標以加強董事會運作效率，
檢立績效目標以加強董事會運柞徘櫚，	建立績效目標以加強董事會運作效率，
建立溪效目包以加強懂事會運作效率，	建立績效目標以加強董事會運作效率，
建立績效目標以加強董事會運作效率，	建立績效目標以加強董事會運作效率，
建立績效目標以加強董事會運作嘯率，	建立績效目標以加強董事會運作效率，
中華電信訂有《董事會績效評估辦髮》，嚴謹且詳寄規範懂事軌績效評估事宜，	中華電信訂有《董事會績效評估辦法》，嚴謹且詳細規範董事會績效評估事宜，
冢華電信訂有《董事會績效評估半法》，嚴謹且詳細規範董事規績效屏窟事宜，	中華電信訂有《董事會績效評估辦法》，嚴謹且詳細規範董事會績效評估事宜，
掉華電信訂有《董事會睛效評估辦法》，演謹且詳細規範董事會績效評估耜宜，	中華電信訂有《董事會績效評估辦法》，嚴謹且詳細規範董事會績效評估事宜，
中華電信訂有《董事會績絞評咕辦法》，嚴謹且庠細規范董事會績轎評估事宜，	中華電信訂有《董事會績效評估辦法》，嚴謹且詳細規範董事會績效評估事宜，
衷華電信訂有《董事會績效萍估辦法》，嚴謹且洽細規梵董事會績踵評咕嗜宜，	中華電信訂有《董事會績效評估辦法》，嚴謹且詳細規範董事會績效評估事宜，
包括每年進邢一次內部評估，並至少每三年一刺由外部專業獨立機構或外龐專韁學者團隊執行董事會績效評估。	包括每年進行一次內部評估，並至少每三年一次由外部專業獨立機構或外部專家學者團隊執行董事會績效評估。
包颳每年錦行一次內部評估，並至少每三念一次由外部專業獨立機構或外部專家學者團隊執行董事會激效評估。	包括每年進行一次內部評估，並至少每三年一次由外部專業獨立機構或外部專家學者團隊執行董事會績效評估。
包括每年進行氤次內部評估，並至少每三年一次由外步專業獨立機構或外部專頰學者團隊執行董事圭記效評估。	包括每年進行一次內部評估，並至少每三年一次由外部專業獨立機構或外部專家學者團隊執行董事會績效評估。
包蝸鎂年進形一次內部評估，並至少每舢年一次由外部專業獨立機構火外部專家學者團隊痔行董事會績效評估。	包括每年進行一次內部評估，並至少每三年一次由外部專業獨立機構或外部專家學者團隊執行董事會績效評估。
包颳每年進行揖次內部瓶估，並殖少美三年食次由外部專業獨立機構伙外部專家懼者團隊執行董事會績效評估。	包括每年進行一次內部評估，並至少每三年一次由外部專業獨立機構或外部專家學者團隊執行董事會績效評估。
2022 年完成董事成員績效瓶估自坪、董事會績效暫估自評、功能性委員會績效評估自評，	2022 年完成董事成員績效評估自評、董事會績效評估自評、功能性委員會績效評估自評，
2022 年頑成董事成員給效評估自評、董事會績效萍估自評、功能性委員會績消平估自評，	2022 年完成董事成員績效評估自評、董事會績效評估自評、功能性委員會績效評估自評，
2022 年完成董事成員績效評估自評、董事會脊效評咕自評、功能性委員會績效評估孜聘，	2022 年完成董事成員績效評估自評、董事會績效評估自評、功能性委員會績效評估自評，
2022 年完成董事成員績效評估自評、凍事會績效評估自評、功能性委員會績效評估自評，	2022 年完成董事成員績效評估自評、董事會績效評估自評、功能性委員會績效評估自評，
2022 年完成董事成員西效評枯自評、懂事會岌效評估自評、龔能性委員會績效屏估自評，	2022 年完成董事成員績效評估自評、董事會績效評估自評、功能性委員會績效評估自評，
並委託臺灣程正經營穌會進行歪部評姦，	並委託臺灣誠正經營學會進行外部評鑑，
並委託臺灣誠正竟宜學會襟行外部評鑑，	並委託臺灣誠正經營學會進行外部評鑑，
並委託臺剜誠正經營學建進行外部評絹，	並委託臺灣誠正經營學會進行外部評鑑，
並委託臺灣誠正經胰學慧進行腕部評鑑，	並委託臺灣誠正經營學會進行外部評鑑，
並委託臺灣誠正經營學會晉型外部評鑑，	並委託臺灣誠正經營學會進行外部評鑑，
外部獨黎評鑑結果包括：董事會專業職能與決策效能,	外部獨立評鑑結果包括：董事會專業職能與決策效能,
外部杜立評鑑結果包卦：董事會專業職能與決策俏能,	外部獨立評鑑結果包括：董事會專業職能與決策效能,
外部獨立萍芥界果苞括：董事會專業職能與決策效耿,	外部獨立評鑑結果包括：董事會專業職能與決策效能,
外捕獨立評鑑結果包括：董獅簣專業職能與決策效能,	外部獨立評鑑結果包括：董事會專業職能與決策效能,
外步獨立評眷結拱包括：董事會專業職能與決策效能,	外部獨立評鑑結果包括：董事會專業職能與決策效能,
董市會對於企業內部控制之監督,對永續經營之悅堵股東權益維護，	董事會對於企業內部控制之監督,對永續經營之態度股東權益維護，
董事會對於企業內部控制之湔督,對永續經營之態度股東券弈維壺，	董事會對於企業內部控制之監督,對永續經營之態度股東權益維護，
董事會對於企業內部控制之菅督,對永續經營之太度鼓東權益維護，	董事會對於企業內部控制之監督,對永續經營之態度股東權益維護，
董事會對幻企業內部控制之監督,兌永續經營之態度股東權益維護，	董事會對於企業內部控制之監督,對永續經營之態度股東權益維護，
懂事會對於企業內部控制之監督,對永續經營之態度股東詮益維護，	董事會對於企業內部控制之監督,對永續經營之態度股東權益維護，
中華電信遵循公司擲理的精身進行制度與措施變革及羞正，	中華電信遵循公司治理的精神進行制度與措施變革及修正，
中薪電信遵循鞏司治理的精神進形制度與措施秒革及修證，	中華電信遵循公司治理的精神進行制度與措施變革及修正，
中華電信遵循公司治勵的精神進行恕度與措施變革即修振，	中華電信遵循公司治理的精神進行制度與措施變革及修正，
忠華電釁遵循公司治理穆精神盡行制扉與措使變革襲岫正，	中華電信遵循公司治理的精神進行制度與措施變革及修正，
中華電幸遵循公瑤緻理的精神進行制度與措施變革及修正，	中華電信遵循公司治理的精神進行制度與措施變革及修正，
包括：實施電子投票制度、股東會議案採誅案靴決及在官方網站揭露全部議盎的表決結國等，	包括：實施電子投票制度、股東會議案採逐案表決及在官方網站揭露全部議案的表決結果等，
包括：蝕施電子投驃制度、股東會議案採鰻案表決及在官方惘站揭露全部議安的表決結果等，	包括：實施電子投票制度、股東會議案採逐案表決及在官方網站揭露全部議案的表決結果等，
包括：實施墊子投票制度、股東會倚盎採逐盎表決及在官方網脹揭嚕全布議案的表決攜狗等，	包括：實施電子投票制度、股東會議案採逐案表決及在官方網站揭露全部議案的表決結果等，
包括：實施澱子投票制渡、股東軌議案採足案表決記在官方網站揭露拳部議案的表決結果等，	包括：實施電子投票制度、股東會議案採逐案表決及在官方網站揭露全部議案的表決結果等，
包括：實施電子透瓢制度、股東會議案採逐案表決及在乖方網站揭露全部議案的表決結果等，	包括：實施電子投票制度、股東會議案採逐案表決及在官方網站揭露全部議案的表決結果等，
提供股東多元的議事參與管道，充分讓股東行使其權利，	提供股東多元的議事參與管道，充分讓股東行使其權利，
提供股東多元的議事參與管道，充分讓股東行使其權利，	提供股東多元的議事參與管道，充分讓股東行使其權利，
提供股東多元的均事參與管道，充分浪鈷通行使其權利，	提供股東多元的議事參與管道，充分讓股東行使其權利，
提工股東跺元的議尸參與管道，充分壤股東行市基權利，	提供股東多元的議事參與管道，充分讓股東行使其權利，
提供股東多元的議事信與管道，充分讓股東行使其權利，	提供股東多元的議事參與管道，充分讓股東行使其權利，
具體提升供肆治理成效。創造股東價值，	具體提升公司治理成效。創造股東價值，
具體題呻公斯治理丞效。創罩股東價職，	具體提升公司治理成效。創造股東價值，
具體提乘公司治理成效。窗造股東價值，	具體提升公司治理成效。創造股東價值，
具體提升公司治理成效。創皂股東價值，	具體提升公司治理成效。創造股東價值，
具棣提升功司治理成效。創造股通恰值，	具體提升公司治理成效。創造股東價值，
2022 年，中華電信合冰總瀛收達 2,167 億元，我們專注畚屆並積極創新，	2022 年，中華電信合併總營收達 2,167 億元，我們專注本業並積極創新，
2022 年，中華電信合併總營收達 2,167 億筵，我們專注本業并積極創新，	2022 年，中華電信合併總營收達 2,167 億元，我們專注本業並積極創新，
2022 年，中華電信合併總營收達 2,167 億元，喔們轉注本業並蟋極創新，	2022 年，中華電信合併總營收達 2,167 億元，我們專注本業並積極創新，
2022 蓮，中華電信合併總營收達 2,167 億元，我們專注本業並積極創新，	2022 年，中華電信合併總營收達 2,167 億元，我們專注本業並積極創新，
2022 年，中花電細合併總營收達 2,167 乙元，我們轉佇奔業並積極創新，	2022 年，中華電信合併總營收達 2,167 億元，我們專注本業並積極創新，
為顫業及國家做出實質且重大的貢獻，	為產業及國家做出實質且重大的貢獻，
為產業及國家做出實質苣重大的貢獻，	為產業及國家做出實質且重大的貢獻，
為產拽及國家做出實質且鐘大的貢獻，	為產業及國家做出實質且重大的貢獻，
為諂愿及摑家做出實質且重大的貢獻，	為產業及國家做出實質且重大的貢獻，
為產業及國袈做出實質且重大的供獻，	為產業及國家做出實質且重大的貢獻，
並為股東創造最大匠值。因窠雇升級 5G 服務及行動客戶駿增加，	並為股東創造最大價值。因客戶升級 5G 服務及行動客戶數增加，
並為股東創造最大價值。因客戶升級 5G 服務及行動客戶數增加，	並為股東創造最大價值。因客戶升級 5G 服務及行動客戶數增加，
並為股東創造最大甲值。因客戶升級 5G 服務及行動客雇數增僵，	並為股東創造最大價值。因客戶升級 5G 服務及行動客戶數增加，
並為股東創造最大價值。照客戶升級 5G 服務計行動刻戶數增加，	並為股東創造最大價值。因客戶升級 5G 服務及行動客戶數增加，
並為穀東創造最大價蛭。因客糊升級 5G 服務及行動客雇數憎加，	並為股東創造最大價值。因客戶升級 5G 服務及行動客戶數增加，
使行動服務營收增加，及資通訊專案如職、如質完工，	使行動服務營收增加，及資通訊專案如期、如質完工，
使行動模務營收增加，及資通訊轉案如期、如質冉工，	使行動服務營收增加，及資通訊專案如期、如質完工，
使行東服務飴收增加，輯資通訊專案如期、乳職完工，	使行動服務營收增加，及資通訊專案如期、如質完工，
使行動服務營收增加，及淄通馴專案如期、如質完工，	使行動服務營收增加，及資通訊專案如期、如質完工，
使晴動服唔營收增加，及貲通訊專案如期、如質完弓，	使行動服務營收增加，及資通訊專案如期、如質完工，
增益專標案營收，2022 年整體營收與 2021 年相比成長；2022 黏，	增益專標案營收，2022 年整體營收與 2021 年相比成長；2022 年，
增益專標案營收，2022 年整體營收覲 2021 碾相比成長；2022 年，	增益專標案營收，2022 年整體營收與 2021 年相比成長；2022 年，
增益專標案營收，2022 年整體營收齬 2021 年相比成長；2022 年，	增益專標案營收，2022 年整體營收與 2021 年相比成長；2022 年，
憎頤專標案營蒐，2022 年整題營收與 2021 年襄比成長；2022 年，	增益專標案營收，2022 年整體營收與 2021 年相比成長；2022 年，
贈益磚標案營收，2022 年整體狂收蕪 2021 年相餅成長；2022 年，	增益專標案營收，2022 年整體營收與 2021 年相比成長；2022 年，
歸屬於母公司的淨李為 365 億元、每鼓盈餘 (EPS)4.	歸屬於母公司的淨利為 365 億元、每股盈餘 (EPS)4.
歸屬於母公詩的敬利為 365 怡元、每股盈餘 (EPS)4.	歸屬於母公司的淨利為 365 億元、每股盈餘 (EPS)4.
歸贖於母公撕的淨利為 365 硬怨、每股瀛餘 (EPS)4.	歸屬於母公司的淨利為 365 億元、每股盈餘 (EPS)4.
窺屬於母贛司的逕栗為 365 億元、每股盈餘 (EPS)4.	歸屬於母公司的淨利為 365 億元、每股盈餘 (EPS)4.
歸屬迂母公司的警慄為 365 捐元、非股盈餘 (EPS)4.	歸屬於母公司的淨利為 365 億元、每股盈餘 (EPS)4.
70 元。混華電釁裁捂健全並依法丞實納稅，	70 元。中華電信財務健全並依法誠實納稅，
70 元。週花電信財務健全並依返淳實納稅，	70 元。中華電信財務健全並依法誠實納稅，
70 元。中華電信財務嵌全並依法誠實納稅，	70 元。中華電信財務健全並依法誠實納稅，
70 元。中華電信財務健全並依法誠提納稅，	70 元。中華電信財務健全並依法誠實納稅，
70 元。中華電信財務健卷婢依髮誠實納稅，	70 元。中華電信財務健全並依法誠實納稅，
2022 黏合併所得稅有效稅率約 19.54%，愉法定稅縷 20% 及全穹產業平均的差異，	2022 年合併所得稅有效稅率約 19.54%，與法定稅率 20% 及全球產業平均的差異，
2022 年合併所得稅有效水率約 19.54%，蕪法定遂率 20% 及全球產業平均的差異，	2022 年合併所得稅有效稅率約 19.54%，與法定稅率 20% 及全球產業平均的差異，
2022 廿合併所得稅有效稅率約 19.54%，與法定稅濾 20% 及全球產業瓶均的差異，	2022 年合併所得稅有效稅率約 19.54%，與法定稅率 20% 及全球產業平均的差異，
2022 年合併所德蛻有酵睡率約 19.54%，與法定稅率 20% 技全球產業平肌的差異，	2022 年合併所得稅有效稅率約 19.54%，與法定稅率 20% 及全球產業平均的差異，
2022 連合併所得稅友效鬆率約 19.54%，竅法定睡率 20% 及全球產靨平均的喳蜴，	2022 年合併所得稅有效稅率約 19.54%，與法定稅率 20% 及全球產業平均的差異，
主要倭依沮我果所得稅法第 42 條，營走事業投姊國餒其他營利事業，	主要為依據我國所得稅法第 42 條，營利事業投資國內其他營利事業，
主要為依據我國所得稅幕第 42 條，營利事業透資國內其他營利事業，	主要為依據我國所得稅法第 42 條，營利事業投資國內其他營利事業，
俎要危依據我國所得稅法第 42 條，膺狸事業投資國內其他瑛利事業，	主要為依據我國所得稅法第 42 條，營利事業投資國內其他營利事業，
祖要偎依據我國所得稅髮第 42 條，營利事業投資摑內其他硬利事業，	主要為依據我國所得稅法第 42 條，營利事業投資國內其他營利事業，
主要為依據我國所得稅法第 42 條，營麗事業投資國內其他營利事業，	主要為依據我國所得稅法第 42 條，營利事業投資國內其他營利事業，
獲配的股利淨蚵伙盈餘淨額免徵所得琶；另依產業創新佻吏第 10 條牲請投資抵減的租稅優惠。	獲配的股利淨額或盈餘淨額免徵所得稅；另依產業創新條例第 10 條申請投資抵減的租稅優惠。
獲配的股利菁額厚盈餘淨俄免徵所得稅；另依產業愴新條例第 10 條申請投資牴減的租稅優惠。	獲配的股利淨額或盈餘淨額免徵所得稅；另依產業創新條例第 10 條申請投資抵減的租稅優惠。
獲佩的股利淨額或盈餘淨額免徵所得稅；另依產宴創新條例第 10 條申請投滋抵減的租稅優惠。	獲配的股利淨額或盈餘淨額免徵所得稅；另依產業創新條例第 10 條申請投資抵減的租稅優惠。
獲配的股利淨兒或盈餘淨額免徵所得稅；菱依產爺創猩條例第 10 條申請潼資抵減的租稅優惠。	獲配的股利淨額或盈餘淨額免徵所得稅；另依產業創新條例第 10 條申請投資抵減的租稅優惠。
獲配的股利淨額或盈餘淨額免徵所得稅；另炬產業創新條令第 10 條申請投資抵減的租水優惠。	獲配的股利淨額或盈餘淨額免徵所得稅；另依產業創新條例第 10 條申請投資抵減的租稅優惠。
重視誠信道德，為強化誠信經營竇理作為，	重視誠信道德，為強化誠信經營管理作為，
重視誠釁道德，為牆化誠信經營館理作為，	重視誠信道德，為強化誠信經營管理作為，
重視誠信道德，為強化誠薪經營管理左為，	重視誠信道德，為強化誠信經營管理作為，
重視誠信道德，為強化誠信頸營管理作為，	重視誠信道德，為強化誠信經營管理作為，
重視誠信道德，為強畫誠信勁營管理作為，	重視誠信道德，為強化誠信經營管理作為，
中畫電信訂魷《誠祇經營嗾則》、《行為準則》作為最高商業道德規範，	中華電信訂有《誠信經營守則》、《行為準則》作為最高商業道德規範，
中華電信訂有《誠信經營守則》、《行孀準則》作為墜高商射島德規範，	中華電信訂有《誠信經營守則》、《行為準則》作為最高商業道德規範，
中華奠信釘有《誠信經營守仄》、《行為準則》裝為最篙商業道德規范，	中華電信訂有《誠信經營守則》、《行為準則》作為最高商業道德規範，
中肓電信訂有《撐信經營守則》、《行為準則》佐為最高商業道德規範，	中華電信訂有《誠信經營守則》、《行為準則》作為最高商業道德規範，
中華電信訂有《誠信犄瑛嗾則》、《行為準則》作為最高商業道矩規範，	中華電信訂有《誠信經營守則》、《行為準則》作為最高商業道德規範，
並深化對員工際外部害乖係人（供應鏈夥伴）之宣導及窖育，	並深化對員工及外部害關係人（供應鏈夥伴）之宣導及教育，
並深化對顏工及外部害關係仍（供硬聯夥伴）之宣導及教育，	並深化對員工及外部害關係人（供應鏈夥伴）之宣導及教育，
並深化對員工棘外部害關係人（供應鏈夥伴）之宣導及教育，	並深化對員工及外部害關係人（供應鏈夥伴）之宣導及教育，
並深化對爰工及外簿害倨係人（供應鏈吼伴）之眩導及教育，	並深化對員工及外部害關係人（供應鏈夥伴）之宣導及教育，
並伸猾堆員工及外部害關係人（供應鏈夥鋁）之宣導算教育，	並深化對員工及外部害關係人（供應鏈夥伴）之宣導及教育，
連續 4 年通過 SGS-Taiwan《行為準則》符盍性獨礫迅查震。	連續 4 年通過 SGS-Taiwan《行為準則》符合性獨立性查證。
連續 4 年通過 SGS-Taiwan《行厄准澤》符合性獨立性受證。	連續 4 年通過 SGS-Taiwan《行為準則》符合性獨立性查證。
年續 4 年通過 SGS-Taiwan《行為準則》符合性獨立性查證。	連續 4 年通過 SGS-Taiwan《行為準則》符合性獨立性查證。
連頊 4 年通過 SGS-Taiwan《行為準則》符合性獨立性查證。	連續 4 年通過 SGS-Taiwan《行為準則》符合性獨立性查證。
連續 4 年通過 SGS-Taiwan《行為諄則》符合性都立型岔證。	連續 4 年通過 SGS-Taiwan《行為準則》符合性獨立性查證。
2022廉的誠信驚營守則相關規定宣導與測驗，	2022年的誠信經營守則相關規定宣導與測驗，
2022年的誠信鏡營守則襄關規定宣導與測驗，	2022年的誠信經營守則相關規定宣導與測驗，
2022年的誠心經營守則相關規定宣導與測驗，	2022年的誠信經營守則相關規定宣導與測驗，
2022簾的誠信經營受則相關詭定暹導與測奄，	2022年的誠信經營守則相關規定宣導與測驗，
2022年的誠信經營嗾囁相關規定宣討與測驗，	2022年的誠信經營守則相關規定宣導與測驗，
於9屈12日至10月7日進行，同時賑堆鈐體員工實施溯位學習鑰讀《行為準責與誠信經營叟則》宣導課程，	於9月12日至10月7日進行，同時針對全體員工實施數位學習閱讀《行為準則與誠信經營守則》宣導課程，
於9月12日至10月7日僅行，同時楨對全梯員工實釋數薇學蓆閱圖《行為準則與誠信經營守則》宣悼課程，	於9月12日至10月7日進行，同時針對全體員工實施數位學習閱讀《行為準則與誠信經營守則》宣導課程，
於9月12日至10約7日進行，同時針對咋體琊工實施數位學習衛讀《型為準則與誠信經營守囁》宣刀課程，	於9月12日至10月7日進行，同時針對全體員工實施數位學習閱讀《行為準則與誠信經營守則》宣導課程，
兀9月12日至10月7日進型，同時針對鈐體員工實施傑位學習閱讀《型為準琺與誠信經營守仄》宣導課程，	於9月12日至10月7日進行，同時針對全體員工實施數位學習閱讀《行為準則與誠信經營守則》宣導課程，
於9月12日至10月7日進行，同時陣對全體員工實施數未學習閱讀《行為準則與誠薪經營守則》宣導課程，	於9月12日至10月7日進行，同時針對全體員工實施數位學習閱讀《行為準則與誠信經營守則》宣導課程，
扣除請娩假、倦傷假及長期摒假等原因，	扣除請娩假、公傷假及長期病假等原因，
扣除濟娩假、公傷假及長期賓夏等原因，	扣除請娩假、公傷假及長期病假等原因，
扣屠請美假、公傷假及長期病假等原因，	扣除請娩假、公傷假及長期病假等原因，
扣除請娩假、郭傷假及長期病假等原因，	扣除請娩假、公傷假及長期病假等原因，
扣除請娩假、公傷講及長期病鎳等斜因，	扣除請娩假、公傷假及長期病假等原因，
19,596 位員工 100% 丸呈側驗，以具體管理機制，確保索有員工均能以最高倫旎標準從事鶯運活動。	19,596 位員工 100% 完成測驗，以具體管理機制，確保所有員工均能以最高倫理標準從事營運活動。
19,596 位員工 100% 完成測靨，以具體管理機制，確保所有員工駿能以嘴高倫理標準從寺營運活棟。	19,596 位員工 100% 完成測驗，以具體管理機制，確保所有員工均能以最高倫理標準從事營運活動。
19,596 位圓工 100% 完瞠測雁，以具體管理機制，確保所有員工均能蛾最高論理標準從事營運活動。	19,596 位員工 100% 完成測驗，以具體管理機制，確保所有員工均能以最高倫理標準從事營運活動。
19,596 位員工 100% 完懲測驗，以具體管理集制，確保所有袁工均能以最高倫理標準鐘事營陰活冽。	19,596 位員工 100% 完成測驗，以具體管理機制，確保所有員工均能以最高倫理標準從事營運活動。
19,596 位員工 100% 完成測驗，以具體管理機支，確保所有宛工鈞能以最高倫理標疹從事景運穫度。	19,596 位員工 100% 完成測驗，以具體管理機制，確保所有員工均能以最高倫理標準從事營運活動。
在良好機制控管下，2022 年並無任何重大違反法規之情事發生。	在良好機制控管下，2022 年並無任何重大違反法規之情事發生。
在良好機制控管下，2022 簾並無任何鐘大違反法閨之情事發生。	在良好機制控管下，2022 年並無任何重大違反法規之情事發生。
在良好機制控管下，2022 年病謨任何重大違反法規之情示憐生。	在良好機制控管下，2022 年並無任何重大違反法規之情事發生。
在良好機制控管下，2022 年睥無任何重大違反法規之情室發生。	在良好機制控管下，2022 年並無任何重大違反法規之情事發生。
債良好轟制控管下，2022 年並無任何重大違返瞥規之其事發生。	在良好機制控管下，2022 年並無任何重大違反法規之情事發生。
我們將誠信經嬴鄭策與員工績效考核及人力資源政策結赫，	我們將誠信經營政策與員工績效考核及人力資源政策結合，
我們將誠信經營政策與員工績效考核及人力資源政策桀合，	我們將誠信經營政策與員工績效考核及人力資源政策結合，
我們獎誠信經夤政惻與員龔績效犒核及人力資源政策結合，	我們將誠信經營政策與員工績效考核及人力資源政策結合，
我們將誠信經營政策王園公績效考核及人立資源政策結合，	我們將誠信經營政策與員工績效考核及人力資源政策結合，
我們將誠信經營政坼尉員工績效考核及人蠣資枇政策結合，	我們將誠信經營政策與員工績效考核及人力資源政策結合，
設立明確有效質獎懲制度，訂有《從厭人員烤核要點》及《從宴人員獎懲標準》沛為員工考核依據，	設立明確有效之獎懲制度，訂有《從業人員考核要點》及《從業人員獎懲標準》做為員工考核依據，
設立明確有效之獎懲制度，訂有《從業人員槁核要點》及《從業人員享懲標準》做為員工考核茵蓄，	設立明確有效之獎懲制度，訂有《從業人員考核要點》及《從業人員獎懲標準》做為員工考核依據，
設立名確有俏之獎懲制度，訂有《從業人願考核要點》騎《從業仍員獎懲標準》做為員拱考核依據，	設立明確有效之獎懲制度，訂有《從業人員考核要點》及《從業人員獎懲標準》做為員工考核依據，
設立明確有效蜘講懲制度，訂有《鬃業人員考核要點》及《從業人緣獎懲標準》做為員工考核依據，	設立明確有效之獎懲制度，訂有《從業人員考核要點》及《從業人員獎懲標準》做為員工考核依據，
設立明確有效之蔣承制度，訂有《從業人員考核要舔》及《從業人娣槳懲標準》奏為員工考核依局，	設立明確有效之獎懲制度，訂有《從業人員考核要點》及《從業人員獎懲標準》做為員工考核依據，
若遇有足莓鼓勵的事蹟或應懲初行為時，	若遇有足資鼓勵的事蹟或應懲處行為時，
若寤有足資鼓勵的事蹟或應懲處行為試，	若遇有足資鼓勵的事蹟或應懲處行為時，
若遇有聚資鼓勵的事蹟或應晨處行為時，	若遇有足資鼓勵的事蹟或應懲處行為時，
若遇酉足資鼓勵的事蹟或應懲處行為時，	若遇有足資鼓勵的事蹟或應懲處行為時，
若遇有足資鼓勵的弛蹟或應懲處行為時，	若遇有足資鼓勵的事蹟或應懲處行為時，
依規定拋時辦理獎懲。負面舂學補救程序，	依規定即時辦理獎懲。負面衝擊補救程序，
依規定即時辦理獎懲。負面衝擊補救程酗，	依規定即時辦理獎懲。負面衝擊補救程序，
壹規訂即時辦理獎懲。負蔑衝擊補救秤序，	依規定即時辦理獎懲。負面衝擊補救程序，
依規定即時辦理獎懲。負面衝擊補救程序，	依規定即時辦理獎懲。負面衝擊補救程序，
依規定戢時辦禮獎層。負面衝擊補救程序，	依規定即時辦理獎懲。負面衝擊補救程序，
我們設置多簷溝通管道，血保所有利害關係人皆可逗過各種管道表達議見，	我們設置多元溝通管道，確保所有利害關係人皆可透過各種管道表達意見，
我們設置多元鉤通管道，確保所有利害關係人皆可透過鉻種管到表達意見，	我們設置多元溝通管道，確保所有利害關係人皆可透過各種管道表達意見，
我們設置跺元溝恫管道，確保叟有利害關係人皆可透過鉻種管道賤達意見，	我們設置多元溝通管道，確保所有利害關係人皆可透過各種管道表達意見，
我們賒置多元溝通管到，確保所有利害關係人皆葛透過各種管道表達頤見，	我們設置多元溝通管道，確保所有利害關係人皆可透過各種管道表達意見，
我們設置多元溝通管道，確褓所有利害關係仍接可透過各種管道表達意見，	我們設置多元溝通管道，確保所有利害關係人皆可透過各種管道表達意見，
提出申訴及檢舉，我們會針對所牖負面衝擊進行妥善回應、處理及補臼，	提出申訴及檢舉，我們會針對所有負面衝擊進行妥善回應、處理及補救，
蹄出申訴及檢舉，我們會針堆所有賦麵衝擊進行妥善回應、處理及補救，	提出申訴及檢舉，我們會針對所有負面衝擊進行妥善回應、處理及補救，
提出申訴及檢舉，窩們會針對所有釜面衝擊進行妥善回應、儲羊及補救，	提出申訴及檢舉，我們會針對所有負面衝擊進行妥善回應、處理及補救，
提出申訴及檢舉，我們會針對所有負麵衝擊進型橢善回應、處理及補救，	提出申訴及檢舉，我們會針對所有負面衝擊進行妥善回應、處理及補救，
鏑出申訴及檢舉，我們會針對所有負面衝擊冀型妥贍回應、處理及補嗅，	提出申訴及檢舉，我們會針對所有負面衝擊進行妥善回應、處理及補救，
並根據利害關汐漆之回饋意見，強化溝通協調與應變機制，	並根據利害關係人之回饋意見，強化溝通協調與應變機制，
並根據利害關係人之回饋意見，強化溝通協調與應變機制，	並根據利害關係人之回饋意見，強化溝通協調與應變機制，
並根據涼害關係妊之回饋意劍，強化溝通協調與應變機制，	並根據利害關係人之回饋意見，強化溝通協調與應變機制，
並根娶利害關係仍之回饋意見，牆化溝恫協調與應變犄制，	並根據利害關係人之回饋意見，強化溝通協調與應變機制，
並根據利骸關係人之回貴意見，逗化溝通協調與應變機制，	並根據利害關係人之回饋意見，強化溝通協調與應變機制，
削保更符合利害關係人之需求。防琺貪腐，	確保更符合利害關係人之需求。防範貪腐，
確保更符合利害關係人之需求。防範貪腐，	確保更符合利害關係人之需求。防範貪腐，
確保羹符合利戮關係人之需求。防悍貪輔，	確保更符合利害關係人之需求。防範貪腐，
確保更符合利害關戲仍之需求。防範貪腐，	確保更符合利害關係人之需求。防範貪腐，
確保更符合利害關係人之仁求。防範彈腐，	確保更符合利害關係人之需求。防範貪腐，
中華電信堅守貪腐零容忍原則，訂有《中華電釁反貪腐與反角錢証策》來規範所有營運及商業之互動關係，	中華電信堅守貪腐零容忍原則，訂有《中華電信反貪腐與反洗錢政策》來規範所有營運及商業之互動關係，
中花澱信堅守貪腐聆容忍原則，訂有《中華電信反貪腐與反洗錢政策》來規範所有營運及商腋之互動關膝，	中華電信堅守貪腐零容忍原則，訂有《中華電信反貪腐與反洗錢政策》來規範所有營運及商業之互動關係，
中華電信堅守貪腐翎容忍原則，訂有《中華電信反貪牡與罕洗錢政策》來規範梭有營運及商業紙互咚關係，	中華電信堅守貪腐零容忍原則，訂有《中華電信反貪腐與反洗錢政策》來規範所有營運及商業之互動關係，
中華典信堅守貪腐零容忍原則，訂有《中肓電信反貪輔與反洗遣掙羞》來規範所有營運既商業之互動關係，	中華電信堅守貪腐零容忍原則，訂有《中華電信反貪腐與反洗錢政策》來規範所有營運及商業之互動關係，
中華電信堅首貪腐零容忍原則，訂有《中話電信反貪符與返洗錢政側》來桂範所有景運及商業之互脅棺係，	中華電信堅守貪腐零容忍原則，訂有《中華電信反貪腐與反洗錢政策》來規範所有營運及商業之互動關係，
枕策涵蓋對象包括董事、全體員工、供應殤等，	政策涵蓋對象包括董事、全體員工、供應商等，
政策涵蓋對象包夸董提、全剔嚴工、供應商等，	政策涵蓋對象包括董事、全體員工、供應商等，
政策涵蓋對翔包光董事、全體員工、供應商等，	政策涵蓋對象包括董事、全體員工、供應商等，
鴆策涵蓋對象包括棟事、全邸員共、供應商等，	政策涵蓋對象包括董事、全體員工、供應商等，
政策涵慨對象包括董軾、全體員工、肱應鯊等，	政策涵蓋對象包括董事、全體員工、供應商等，
2022 年起，由行政長（Chief Administrative Officer，淺稱 CAO）擔任負責人，專責監督與指導商業道德和貪腐議題，	2022 年起，由行政長（Chief Administrative Officer，簡稱 CAO）擔任負責人，專責監督與指導商業道德和貪腐議題，
2022 年起，由行政長（Chief Administrative Officer，簡稱 CAO）擔任負責人，專責監督與指導商業道德紇貪腐議弟，	2022 年起，由行政長（Chief Administrative Officer，簡稱 CAO）擔任負責人，專責監督與指導商業道德和貪腐議題，
2022 年起，由形政瘴（Chief Administrative Officer，簡稱 CAO）丹任負責人，專責監督與指導尚業道德和貪腐議題，	2022 年起，由行政長（Chief Administrative Officer，簡稱 CAO）擔任負責人，專責監督與指導商業道德和貪腐議題，
2022 年起，由晴政長（Chief Administrative Officer，簡稱 CAO）擔韋賦責人，專責監督與指討商業道德和貪腐議題，	2022 年起，由行政長（Chief Administrative Officer，簡稱 CAO）擔任負責人，專責監督與指導商業道德和貪腐議題，
2022 年起，由行政長（Chief Administrative Officer，簡稱 CAO）擔任仆責壬，專責監都與指刀商業道德和貪腐議題，	2022 年起，由行政長（Chief Administrative Officer，簡稱 CAO）擔任負責人，專責監督與指導商業道德和貪腐議題，
並巷董事會報告監督成果。我們定期堆誠信經應守則、反貪腐震策等執行作業追蹤並進行風險評估，	並向董事會報告監督成果。我們定期對誠信經營守則、反貪腐政策等執行作業追蹤並進行風險評估，
婢向斗事會報告監督成果。我們鼎期對誠信經贏守則、返貪腐政策等執行作業追蹤丙進行風險評估，	並向董事會報告監督成果。我們定期對誠信經營守則、反貪腐政策等執行作業追蹤並進行風險評估，
並向董事跪報告監督成果。我們地期堆誠信鈞營守則、反貪腐政策等執行作業追蹤並進行風險評估，	並向董事會報告監督成果。我們定期對誠信經營守則、反貪腐政策等執行作業追蹤並進行風險評估，
並象董事會報告監督成果。我們定慼對誠釁經營守則、反貪娑政策等執行作業追鬃跛進行風洗評估，	並向董事會報告監督成果。我們定期對誠信經營守則、反貪腐政策等執行作業追蹤並進行風險評估，
並巷董拭會報告監督成果。我們仃期楷誠信經營守則、反灘腐政策等拓行作業追蹤並進行烽險評估，	並向董事會報告監督成果。我們定期對誠信經營守則、反貪腐政策等執行作業追蹤並進行風險評估，
涵蓋 100% 共 28 鴿機構營運據點，並依菊風鮮評估誡別並無重大貪腐風險。	涵蓋 100% 共 28 個機構營運據點，並依據風險評估鑑別並無重大貪腐風險。
涵蓋 100% 共 28 個機構營員據點，並依崛風險評估鑑別並無重大貪腐風險。	涵蓋 100% 共 28 個機構營運據點，並依據風險評估鑑別並無重大貪腐風險。
遂蓋 100% 共 28 顆機構營運據點，並依漆風險乒估鑑別並無重答貪腐風險。	涵蓋 100% 共 28 個機構營運據點，並依據風險評估鑑別並無重大貪腐風險。
涵蓋 100% 郭 28 個機構營運苣點，並依據風險評估鑑別並無重大貪腐風蘚。	涵蓋 100% 共 28 個機構營運據點，並依據風險評估鑑別並無重大貪腐風險。
涵蓋 100% 共 28 顆機構營運據點，並依據風淺蠅估鑑別並無重大貪腐風險。	涵蓋 100% 共 28 個機構營運據點，並依據風險評估鑑別並無重大貪腐風險。
我們確實要求並管控與中華電信有商宴往來之利害綸忌人，	我們確實要求並管控與中華電信有商業往來之利害關係人，
齷們確實要求並管擴與中華電信有商業往來之利害關係人，	我們確實要求並管控與中華電信有商業往來之利害關係人，
我們確十要求並管控與中華電信有商業往來之利氦罐係壬，	我們確實要求並管控與中華電信有商業往來之利害關係人，
我們確貫要求並管控與中華電信有商業往來之利孩關係人，	我們確實要求並管控與中華電信有商業往來之利害關係人，
渦們削世要求並管控與中花電信友商業往來之逆害關析人，	我們確實要求並管控與中華電信有商業往來之利害關係人，
如供纓商、承籃商等，必須嚴守弘我們相同的反貪腐標準，	如供應商、承攬商等，必須嚴守與我們相同的反貪腐標準，
如供應商、承覽殤等，妣須嚴守與我們相同的反貪腐鰾準，	如供應商、承攬商等，必須嚴守與我們相同的反貪腐標準，
如供應商、承攬商等，陛須嚴守與我們相洞的返貪腐彪準，	如供應商、承攬商等，必須嚴守與我們相同的反貪腐標準，
如供應商、承攬商等，必須椰藪與我們相同的反貪腐鑣準，	如供應商、承攬商等，必須嚴守與我們相同的反貪腐標準，
儒供應商、承攬湯等，必須垣守與我們相同的反貪腐標準，	如供應商、承攬商等，必須嚴守與我們相同的反貪腐標準，
並透過內部屐核機制、安券嚴拱並保密之員工舉報機制，	並透過內部稽核機制、安全嚴謹並保密之員工舉報機制，
並偷過內部稽核機制、安全嚴謹並保米之沅工舉報機制，	並透過內部稽核機制、安全嚴謹並保密之員工舉報機制，
並透過內部稽核機制、安全嚴謹摒保密之員工舉掌箕制，	並透過內部稽核機制、安全嚴謹並保密之員工舉報機制，
並投過內部稽核機制、安全嚴謹痺保密之員汞舉報機制，	並透過內部稽核機制、安全嚴謹並保密之員工舉報機制，
並透過內堡稽核機制、安全嚴謹併保密之員工舉報機制，	並透過內部稽核機制、安全嚴謹並保密之員工舉報機制，
強力檢視內歪部利害寬覬仍棵能發升之不法作為。	強力檢視內外部利害關係人可能發生之不法作為。
強力檢視內外部利害關係人可能發生卮不髮作為。	強力檢視內外部利害關係人可能發生之不法作為。
強力檢視內外部利氦關係人可能發生之暴法作為。	強力檢視內外部利害關係人可能發生之不法作為。
強力檢耜內外部利咳乖係人可能發生之不法蝙為。	強力檢視內外部利害關係人可能發生之不法作為。
岑力檢視念外鋪利害綸係人可能發生之不法作為。	強力檢視內外部利害關係人可能發生之不法作為。
2022 年垢計受理 74 尖申俗檢舉安件，均已依詭定辦理並圈數結案。	2022 年共計受理 74 件申訴檢舉案件，均已依規定辦理並全數結案。
2022 年共計受理 74 件申訴檢齟案件，均已依規定辦理並全數戒案。	2022 年共計受理 74 件申訴檢舉案件，均已依規定辦理並全數結案。
2022 年共際受理 74 件申訴檢舉案劍，均已依閨定辦理並全熟結案。	2022 年共計受理 74 件申訴檢舉案件，均已依規定辦理並全數結案。
2022 年共計受理 74 眷申訴檢舉案件，均已依規定辦裡並全數結案。	2022 年共計受理 74 件申訴檢舉案件，均已依規定辦理並全數結案。
2022 捻共計受理 74 件申訴檢舉盎煎，均已依規逮辦敵並全數結盎。	2022 年共計受理 74 件申訴檢舉案件，均已依規定辦理並全數結案。
2022 年未發蟬行為準則中貪腐、賄賂、歧視、粱擾、各戶隱私個資、利益衝突、洗錢、內線交易等違反案件，	2022 年未發生行為準則中貪腐、賄賂、歧視、騷擾、客戶隱私個資、利益衝突、洗錢、內線交易等違反案件，
2022 年未枋生行為準則中貪腐、賄賂、歧視、騷擾、客戶隱私個資、利益衝突、洗錢、內線交易等違範案件，	2022 年未發生行為準則中貪腐、賄賂、歧視、騷擾、客戶隱私個資、利益衝突、洗錢、內線交易等違反案件，
2022 年未發繩行為準則中貪赴、賄賂、歧視、搔擾、客戶隱巳個資、利益衝突、洗錢、內漩交易躉違反案件，	2022 年未發生行為準則中貪腐、賄賂、歧視、騷擾、客戶隱私個資、利益衝突、洗錢、內線交易等違反案件，
2022 年未發生行為准嘖中貪腐、賄賂、歧侍、騷瑙、刻戶隱祀饒資、利益衝兔、洗錢、座線交易等違反案件，	2022 年未發生行為準則中貪腐、賄賂、歧視、騷擾、客戶隱私個資、利益衝突、洗錢、內線交易等違反案件，
2022 黏未發生行為準蜇棕貪腐、賄賂、歧視、騷擾、客惚隱私個資、利益衝突、洗錢、內線皎易等違反案件，	2022 年未發生行為準則中貪腐、賄賂、歧視、騷擾、客戶隱私個資、利益衝突、洗錢、內線交易等違反案件，
其他巍反紀律案工計 6 件，鈞依據作業櫃定及處理原則辦理調查與議處，	其他違反紀律案共計 6 件，均依據作業規定及處理原則辦理調查與議處，
其他巍反紀律案供計 6 件，均依據作業擊定及處理原則辦理調茶與議處，	其他違反紀律案共計 6 件，均依據作業規定及處理原則辦理調查與議處，
其他違反紀律案共計 6 件，均依據作業規定及處理原則半理調查與議處，	其他違反紀律案共計 6 件，均依據作業規定及處理原則辦理調查與議處，
吉癱違反紀律案共計 6 件，均依據作琊閨定及處理原則辦理調查吳議處，	其他違反紀律案共計 6 件，均依據作業規定及處理原則辦理調查與議處，
其他違反紀律岸共計 6 鑒，均醫據佐業規定及處理原則辦旎調查瑜議處，	其他違反紀律案共計 6 件，均依據作業規定及處理原則辦理調查與議處，
以導砧從業人拌依章行事、維護公司紀賂及股東權肄。	以導正從業人員依章行事、維護公司紀律及股東權益。
以導屯從業人員依臧幸事、維護公司紀律及股東權羯。	以導正從業人員依章行事、維護公司紀律及股東權益。
漪導正鍾業人員依章行事、維護公司紀律及股東權益。	以導正從業人員依章行事、維護公司紀律及股東權益。
以導珍從拽人員依章行事、維惚公司紀律及股局權益。	以導正從業人員依章行事、維護公司紀律及股東權益。
以導正從業人員依章行事、維護公司紀律及股東權益。	以導正從業人員依章行事、維護公司紀律及股東權益。
內部稽核旨災協助董事會及經理人，檢查及覆鵬內部控制制度與衡量營運效率。	內部稽核旨在協助董事會及經理人，檢查及覆核內部控制制度與衡量營運效率。
內卜譏核旨在蠍助董事會及經理人，檢查績覆核糞部控霪制度與衡量營運效率。	內部稽核旨在協助董事會及經理人，檢查及覆核內部控制制度與衡量營運效率。
內部稽閡旨在協助董事會及經勵人，檢查撼福核內部控制礪度與衡量營運效氯。	內部稽核旨在協助董事會及經理人，檢查及覆核內部控制制度與衡量營運效率。
內部稽核旨寨協助董事會及經理人，繭查及覆核內部控制制度與衡量營運效率。	內部稽核旨在協助董事會及經理人，檢查及覆核內部控制制度與衡量營運效率。
內部稽核旨在協助董事會襲經理人，檢查及覆核內部控制制度與衡狐營運效率。	內部稽核旨在協助董事會及經理人，檢查及覆核內部控制制度與衡量營運效率。
中華電信內部稽核單位隸屬董始會，依循規章制度執型稽核業務。	中華電信內部稽核單位隸屬董事會，依循規章制度執行稽核業務。
中華電信內部稽核單位隸屬懂事會，湮循桂章制度執旬稽核業務。	中華電信內部稽核單位隸屬董事會，依循規章制度執行稽核業務。
中華澱信內部稽核單位隸屬董駛會，壹循規章痔度執行稽核業務。	中華電信內部稽核單位隸屬董事會，依循規章制度執行稽核業務。
衷華電辛內部稽核單位隸屬筒事會，依循規章制度執行稽核業務。	中華電信內部稽核單位隸屬董事會，依循規章制度執行稽核業務。
中華電信內部稽核單月唳屬董事會，依循規章制度執行稽核業務。	中華電信內部稽核單位隸屬董事會，依循規章制度執行稽核業務。
每年底依據風險乒估結果擬酊次年稽核計畫，	每年底依據風險評估結果擬訂次年稽核計畫，
每年底依據風險評估結果擬訂次年稽核霽畫，	每年底依據風險評估結果擬訂次年稽核計畫，
每年底膺據風險評估結果擬錠次年稽核計畫，	每年底依據風險評估結果擬訂次年稽核計畫，
每廿底依據風險評哭結果擬紳次年稽核稷划，	每年底依據風險評估結果擬訂次年稽核計畫，
每年底依據風險瓶估結果擬訂瓷年稽核計畫，	每年底依據風險評估結果擬訂次年稽核計畫，
逖報鼕事會通過後，精由網路資鏍系統向主管機關申報備亦。	提報董事會通過後，經由網路資訊系統向主管機關申報備查。
提報董事會通過後，經由網路資訊系統向主管機關申報備查。	提報董事會通過後，經由網路資訊系統向主管機關申報備查。
啼報董事會通貢後，經遊網路資訊系潼向主管機綸申鮑備查。	提報董事會通過後，經由網路資訊系統向主管機關申報備查。
提報陡事會通過後，經由網路滓訊系統向主管乩關申報備查。	提報董事會通過後，經由網路資訊系統向主管機關申報備查。
提報董事會通過後，經由網路梓訊劑統向主管機關申報備察。	提報董事會通過後，經由網路資訊系統向主管機關申報備查。
資訊揭露，中肓電信餅飭誠信、負責及值得信賴的公司治嶺精什，	資訊揭露，中華電信秉持誠信、負責及值得信賴的公司治理精神，
資訊揭露，鬃肓電汐秉持誠信、負責及值得信賴的公司治理精神，	資訊揭露，中華電信秉持誠信、負責及值得信賴的公司治理精神，
漬訊揭露，中華電信秉霉誠信、負責及值得信賴的公司治里精神，	資訊揭露，中華電信秉持誠信、負責及值得信賴的公司治理精神，
資訊揭露，中華電信秉持誠信、負責及值得信賴的公司治鯉精繩，	資訊揭露，中華電信秉持誠信、負責及值得信賴的公司治理精神，
資訊揭露，中花電信秉持澄信、負責及值得信賴的公司治理精神，	資訊揭露，中華電信秉持誠信、負責及值得信賴的公司治理精神，
透過官網、公開資訊觀測站、公嗣年報、永續寶告書，	透過官網、公開資訊觀測站、公司年報、永續報告書，
透忠官網、公開資訊觀測站、公溼年報、永續報告書，	透過官網、公開資訊觀測站、公司年報、永續報告書，
透過官網、公開淄訊寬測站、公司年報、永續報告書，	透過官網、公開資訊觀測站、公司年報、永續報告書，
透過乖望、公開資訊觀測站、公司年報、永續豹告書，	透過官網、公開資訊觀測站、公司年報、永續報告書，
透過貫網、公開資訊觀測站、公司年抱、永續報告書，	透過官網、公開資訊觀測站、公司年報、永續報告書，
以其各式記者簣、法說會等牠元透明的資訊管島，	以及各式記者會、法說會等多元透明的資訊管道，
以及各式記者會、法說匱等多元透明的資訊管道，	以及各式記者會、法說會等多元透明的資訊管道，
以及各式記者會、法說會等多元透明的資迅管道，	以及各式記者會、法說會等多元透明的資訊管道，
以及各式際者會、法說會等多元透明的資訊枴搗，	以及各式記者會、法說會等多元透明的資訊管道，
以及各式記者會、法說會等多元透明的資訊管蹈，	以及各式記者會、法說會等多元透明的資訊管道，
佳強語戾害關係人溝通，蹄聲資訊揭露的速度、品質、瀉衡度及可辛度。	加強與利害關係人溝通，提升資訊揭露的速度、品質、平衡度及可信度。
加強與蒞害關係人溝通，提升資訊界露的速度、品質、平衡度及可信度。	加強與利害關係人溝通，提升資訊揭露的速度、品質、平衡度及可信度。
加強與利害關係人溝恫，偎升資悻皆露頷速度、品質、平衡度及可信度。	加強與利害關係人溝通，提升資訊揭露的速度、品質、平衡度及可信度。
加梁與利害關係人詬通，提升資訊揭露的速度、品質、平衡吐及可信度。	加強與利害關係人溝通，提升資訊揭露的速度、品質、平衡度及可信度。
迦強與利害寬係仁溝通，迪升資訊揭露的速嘟、品質、平衡度檄可信度。	加強與利害關係人溝通，提升資訊揭露的速度、品質、平衡度及可信度。
截至 2022 撚第咎屆公司治理評介，我們已八度獲得前 5%之最優盹佳績，	截至 2022 年第九屆公司治理評鑑，我們已八度獲得前 5%之最優等佳績，
截窒 2022 年第玖懿公司治理評減，我們已八度獲得前 5%脂最優等佳績，	截至 2022 年第九屆公司治理評鑑，我們已八度獲得前 5%之最優等佳績，
截至 2022 年第九尬公司治理評鑑，藕們已八度獲得前 5%之最優等迦績，	截至 2022 年第九屆公司治理評鑑，我們已八度獲得前 5%之最優等佳績，
截至 2022 年第九屆公司治理幛鑑，我們已八度獲得前 5%值最優等家績，	截至 2022 年第九屆公司治理評鑑，我們已八度獲得前 5%之最優等佳績，
截至 2022 年第玖監覺司治理評鑑，我們已八度厚得前 5%之嘴優等佳績，	截至 2022 年第九屆公司治理評鑑，我們已八度獲得前 5%之最優等佳績，
亦於「市值 100 億元疙上電子類」上市櫃企咽中，	亦於「市值 100 億元以上電子類」上市櫃企業中，
亦於「市值 100 億元以上電子類」上市櫃企業中，	亦於「市值 100 億元以上電子類」上市櫃企業中，
亦於「市值 100 億元以上電子類」尚寺櫃七業中，	亦於「市值 100 億元以上電子類」上市櫃企業中，
亦於「市姪 100 億元噫上電子類」上市跪企業中，	亦於「市值 100 億元以上電子類」上市櫃企業中，
亦於「市值 100 億元以上電子類」上駟櫃企業中，	亦於「市值 100 億元以上電子類」上市櫃企業中，
獲得乒鑑結猓鷺佳前 10% 肯錠；另 MSCI 評級已於 2023 年 5 月晉升為 AA 級。	獲得評鑑結果最佳前 10% 肯定；另 MSCI 評級已於 2023 年 5 月晉升為 AA 級。
獲得評鑑結果最佳前 10% 肯定；另 MSCI 評級已於 2023 年 5 月晉升為 AA 級。	獲得評鑑結果最佳前 10% 肯定；另 MSCI 評級已於 2023 年 5 月晉升為 AA 級。
獲得評建結果罪佳前 10% 梱定；綾 MSCI 評級影於 2023 年 5 月晉聲違 AA 級。	獲得評鑑結果最佳前 10% 肯定；另 MSCI 評級已於 2023 年 5 月晉升為 AA 級。
獲得評件結郭最佳前 10% 肯訂；另 MSCI 評唧已於 2023 年 5 月繼伸為 AA 級。	獲得評鑑結果最佳前 10% 肯定；另 MSCI 評級已於 2023 年 5 月晉升為 AA 級。
獲得評鑑姐果醉佳前 10% 肯錠；另 MSCI 評級已於 2023 年 5 月晉聲為 AA 級。	獲得評鑑結果最佳前 10% 肯定；另 MSCI 評級已於 2023 年 5 月晉升為 AA 級。
翅法遵資訊街露部份，中華電信依據「臺灣證券交韻所股份有限公篆對有價證券上視公司重大訊息之查證暨公揩處理程序」規定，	在法遵資訊揭露部份，中華電信依據「臺灣證券交易所股份有限公司對有價證券上市公司重大訊息之查證暨公開處理程序」規定，
在發遵財訊揭露部份，中華電信依鋸「臺灣證券瀟醫所股份友限公司對有價政券上屎公司梟大訊息之查證暨公開處理程徐」規逮，	在法遵資訊揭露部份，中華電信依據「臺灣證券交易所股份有限公司對有價證券上市公司重大訊息之查證暨公開處理程序」規定，
在法遵資訊街六部份，塚華電信指據「臺灣證券交易所股份有限公司對有價證券上市公司重大訊悉之查枕暨公開雛理程序」規釘，	在法遵資訊揭露部份，中華電信依據「臺灣證券交易所股份有限公司對有價證券上市公司重大訊息之查證暨公開處理程序」規定，
在法圳資訊揭露部份，中華巔信依據「臺彎證券簸易所股份有限公司對有價證券上市公司重大訊息之查證季公剴處理程序」規定，	在法遵資訊揭露部份，中華電信依據「臺灣證券交易所股份有限公司對有價證券上市公司重大訊息之查證暨公開處理程序」規定，
在法遵論訊揭露部份，中華電禁依據「臺灣證券交易所股份有限功司脫有價證券繕市公司重大訊息之查喱暨公開處理程序」規定，	在法遵資訊揭露部份，中華電信依據「臺灣證券交易所股份有限公司對有價證券上市公司重大訊息之查證暨公開處理程序」規定，
若誘糟主管肌關才樊或其他行政處分，	若有遭主管機關裁罰或其他行政處分，
若有遭主管機官裁法或其他行政處分，	若有遭主管機關裁罰或其他行政處分，
惹有遭主館機關財罰或媳他行政處分，	若有遭主管機關裁罰或其他行政處分，
若有遭主管機關裁坊或媳他行政處分，	若有遭主管機關裁罰或其他行政處分，
若牖遭主管機關裁罰或其他行政處分，	若有遭主管機關裁罰或其他行政處分，
對財務或業嗚有重大影響，則螫為重大事件（包含裁罰及行征處分），	對財務或業務有重大影響，則視為重大事件（包含裁罰及行政處分），
脫財務或業務有重大影響，則視為重大事件（包含裁罰及行政處分），	對財務或業務有重大影響，則視為重大事件（包含裁罰及行政處分），
對財塢或業務有重大影響，則視為重大事件（包含裁罰及行鎮楚分），	對財務或業務有重大影響，則視為重大事件（包含裁罰及行政處分），
對財務或業務友重大影響，囁視為重大事嵌（包含豺罰及行鎮處分），	對財務或業務有重大影響，則視為重大事件（包含裁罰及行政處分），
對裁務或沿務有重大纓響，則視為重大式件（包含裁罰及型政處分），	對財務或業務有重大影響，則視為重大事件（包含裁罰及行政處分），
會將撕大訊息肩槽於「公開資訊觀測站」。	會將重大訊息揭露於「公開資訊觀測站」。
會將重大訊息揭露於「公開資馴觀測站」。	會將重大訊息揭露於「公開資訊觀測站」。
會將重大訊息揭露於「公開資訊嫖測站」。	會將重大訊息揭露於「公開資訊觀測站」。
會將重大隙息揭露於「公開紫訊觀測站」。	會將重大訊息揭露於「公開資訊觀測站」。
會將種大訊息揭戮於「公開資訊觀測站」。	會將重大訊息揭露於「公開資訊觀測站」。
2022年中華電信皆未有任何糟主管饑關裁坊，	2022年中華電信皆未有任何遭主管機關裁罰，
2022年中華電係尖未柚任紇遭主管霽關裁罰，	2022年中華電信皆未有任何遭主管機關裁罰，
2022年中華癲信階耀有任何遭主管機官裁罰，	2022年中華電信皆未有任何遭主管機關裁罰，
2022年踵華電信皆越有任何遭主館機關裁罰，	2022年中華電信皆未有任何遭主管機關裁罰，
2022黏中華電信捐岳油仁何遭主管機關裁罰，	2022年中華電信皆未有任何遭主管機關裁罰，
或為其塌行政處分之重鴉訊息。強化業務管理品質，	或為其他行政處分之重大訊息。強化業務管理品質，
夥為其塌哼政處分肢重大訊希。強化業務管癘品質，	或為其他行政處分之重大訊息。強化業務管理品質，
或為其他刑政廚分之重大訊息。強晃業鵡管理品質，	或為其他行政處分之重大訊息。強化業務管理品質，
或為其他行政處分支重打訊檄。強化斜伍管理品質，	或為其他行政處分之重大訊息。強化業務管理品質，
或為其他行政處分之重大訊息。強化業務管理品質，	或為其他行政處分之重大訊息。強化業務管理品質，
為提升業務行銷的品質，建立消費者對中華電信匹牌的信閏，	為提升業務行銷的品質，建立消費者對中華電信品牌的信任，
為提升業務媳銷的品質，建立消震者堆中華澱信品牌的信任，	為提升業務行銷的品質，建立消費者對中華電信品牌的信任，
為提笙業務行銷的品質，建立消費者對中華電信品徘的信任，	為提升業務行銷的品質，建立消費者對中華電信品牌的信任，
為提升業兀行銷的品質，建漓消費者隊中華電信品牌的信任，	為提升業務行銷的品質，建立消費者對中華電信品牌的信任，
巍提升夜獄行銷的品質，建立霄費者對中華電幸品岱鬍信任，	為提升業務行銷的品質，建立消費者對中華電信品牌的信任，
並維護良好的晌譽耆棄業形象，我們訂有《業務行銷規範》，	並維護良好的商譽及企業形象，我們訂有《業務行銷規範》，
並維護良好的商譽戢企業刑象，我們訂有《業務涵曉規範》，	並維護良好的商譽及企業形象，我們訂有《業務行銷規範》，
並維馥良好的芟譽及企業形象，我們訂有《業蜈肛椒規範》，	並維護良好的商譽及企業形象，我們訂有《業務行銷規範》，
並維護良好的商兀技企業形象，我們酊有《業務肛銷規範》，	並維護良好的商譽及企業形象，我們訂有《業務行銷規範》，
並維護良好的商譽及企業形象，我們訂有《業務行囂規氾》，	並維護良好的商譽及企業形象，我們訂有《業務行銷規範》，
迆確保業務行銷的執倖符合髮令及主管機綸的規範與要裘。	以確保業務行銷的執行符合法令及主管機關的規範與要求。
以確淇業務行銷的執行符合髮令級主管經關的規範與要求。	以確保業務行銷的執行符合法令及主管機關的規範與要求。
以確保業務行銷的執行符合法令稷主管機關的規範與要求。	以確保業務行銷的執行符合法令及主管機關的規範與要求。
以確保業務行銷爾執行符合法令及主管機關的糞範與要窮。	以確保業務行銷的執行符合法令及主管機關的規範與要求。
已確錶斜務行霄的執行符合髮令及煮管機電的規範與要求。	以確保業務行銷的執行符合法令及主管機關的規範與要求。
因致力於遵循記關規範，2022 念無任荷遭功平交易委巖會裁罰的案件。	因致力於遵循相關規範，2022 年無任何遭公平交易委員會裁罰的案件。
因致力於遵循薑關規範，2022 年無潤何遭公平交譯委員會裁罰的案件。	因致力於遵循相關規範，2022 年無任何遭公平交易委員會裁罰的案件。
因致蠡於遵循相關規範，2022 年無任何遭公藩交易委員會裁罰的案件。	因致力於遵循相關規範，2022 年無任何遭公平交易委員會裁罰的案件。
因致力於遵循相關盔範，2022 年無任何遭公平交易委員會裁罰的案件。	因致力於遵循相關規範，2022 年無任何遭公平交易委員會裁罰的案件。
因致力於遵循相關規範，2022 年無任何遭公平交易委垣會材罰的案戒。	因致力於遵循相關規範，2022 年無任何遭公平交易委員會裁罰的案件。
支持全球性 ESG 矇議與瑰頷，我們自願性遵循聯合國《泉球盟約》原則規範。	支持全球性 ESG 倡議與規範，我們自願性遵循聯合國《全球盟約》原則規範。
支持全球性 ESG 悵議與規範，我們自願性遵循聯合國《全秋盟約》爰則規範。	支持全球性 ESG 倡議與規範，我們自願性遵循聯合國《全球盟約》原則規範。
支治全球鏡 ESG 倡議吳規範，我們自願性遵熄聯合國《全球盟約》原則規範。	支持全球性 ESG 倡議與規範，我們自願性遵循聯合國《全球盟約》原則規範。
支持腱球性 ESG 倡議與溢范，我們自願悻遵循聯合國《全球朦約》原則規範。	支持全球性 ESG 倡議與規範，我們自願性遵循聯合國《全球盟約》原則規範。
支持全邱性 ESG 倡議與瑰繁，我們齜願性遵循聯何摑《全球盟約》原仄規範。	支持全球性 ESG 倡議與規範，我們自願性遵循聯合國《全球盟約》原則規範。
在人權方面，尊重和維護國際公認的各詳人詮，	在人權方面，尊重和維護國際公認的各項人權，
在人痊方面，尊重和維護幗際弓荏的各項人權，	在人權方面，尊重和維護國際公認的各項人權，
在人權方面，尊種褐遺護摑際公認的各項賃權，	在人權方面，尊重和維護國際公認的各項人權，
在人權方面，屯重和危護幗際公認的中項人權，	在人權方面，尊重和維護國際公認的各項人權，
在人權方面，尊重和維護國際公認的鉻項人權，	在人權方面，尊重和維護國際公認的各項人權，
登不參與任何漠視娛踐踏人權的行遺；在勞工咆準方面，	絕不參與任何漠視與踐踏人權的行為；在勞工標準方面，
絕不參與任河刨視與踐踏人權的行為；在勞工標準方面，	絕不參與任何漠視與踐踏人權的行為；在勞工標準方面，
絕暴參與任何摩視與踐踏人咱的行為；在勞工標準方面，	絕不參與任何漠視與踐踏人權的行為；在勞工標準方面，
絕不參與任何漠視與踐踏人權的行為；在勞功標診枋面，	絕不參與任何漠視與踐踏人權的行為；在勞工標準方面，
絕堡參與任何漠視與尷踏人權的行維；仔勞工標肫方面，	絕不參與任何漠視與踐踏人權的行為；在勞工標準方面，
維護員工結社自由、承認及維護嘮資集體談判的權利，	維護員工結社自由、承認及維護勞資集體談判的權利，
維護員工結社自由、承認及維弧撈資媳惡談判的權利，	維護員工結社自由、承認及維護勞資集體談判的權利，
維護員工結社自傭、承刃及維護勞資集體談判的慌厲，	維護員工結社自由、承認及維護勞資集體談判的權利，
維護員工結社字由、承認及薇護勞齜髻體談判的權利，	維護員工結社自由、承認及維護勞資集體談判的權利，
闈護嚴工茄社自由、秤認及維護勞資集體談判的權利，	維護員工結社自由、承認及維護勞資集體談判的權利，
致力消除仁閡形式的不當聊動行為，並杜絕僱用方面的歧視行為。	致力消除任何形式的不當勞動行為，並杜絕僱用方面的歧視行為。
致力消除任何刑式的不當勞動行為，並杜絕瞽用方面的歧視行委。	致力消除任何形式的不當勞動行為，並杜絕僱用方面的歧視行為。
製力消齣任何形式的不當勞動行為，並杜絕僱用方面的歧視行為。	致力消除任何形式的不當勞動行為，並杜絕僱用方面的歧視行為。
致力消除任何邢式的不當勞動行為，並杜絕僱用方面的歧視航為。	致力消除任何形式的不當勞動行為，並杜絕僱用方面的歧視行為。
致力消除任何形式的不當勞動行為，並杜絕僱用方面的歧視行為。	致力消除任何形式的不當勞動行為，並杜絕僱用方面的歧視行為。
中華電徇公開揭示仞權政策並建立箱關之申訴及處李七稚，	中華電信公開揭示人權政策並建立相關之申訴及處理機制，
中華電信公開揭示人權政策檳尬立湘關之神夙及處理機制，	中華電信公開揭示人權政策並建立相關之申訴及處理機制，
中華電信公開揭示人權症策仰建立翔關之申訴及處理機制，	中華電信公開揭示人權政策並建立相關之申訴及處理機制，
中華電信公凱揭蝕壬權政策橙限避相關之申訴及處懍機制，	中華電信公開揭示人權政策並建立相關之申訴及處理機制，
中華電信公開揭示人權政策檳建立相關之申訴及處理機制，	中華電信公開揭示人權政策並建立相關之申訴及處理機制，
持續箱人權議題於公司政策、管理作為中落實。	持續將人權議題於公司政策、管理作為中落實。
持續薑濛權議剔於貢司政策、遮理作為中落實。	持續將人權議題於公司政策、管理作為中落實。
持續將仍權議題於公司政策、管梨作為衷落實。	持續將人權議題於公司政策、管理作為中落實。
持續將人權議題於輝司政策、管戾作為中落實。	持續將人權議題於公司政策、管理作為中落實。
股續將人權議題圬公司政側、管理坐為中落實。	持續將人權議題於公司政策、管理作為中落實。
中華電信學源每黏開授顓班，提供人權議題的講述，	中華電信學院每年開授專班，提供人權議題的講述，
中華電信學院每年開授專班，提供人權議題的講述，	中華電信學院每年開授專班，提供人權議題的講述，
終華電信學院每年開授轉斑，提供人權議題的講述，	中華電信學院每年開授專班，提供人權議題的講述，
中華電信學院每年開授專班，弟供人權議題的講數，	中華電信學院每年開授專班，提供人權議題的講述，
中華奠信學院每年揩授專斑，鏑供人權議題的想述，	中華電信學院每年開授專班，提供人權議題的講述，
遇勞動相關法規羞酊或賑策性議題的調蝙，	遇勞動相關法規修訂或政策性議題的調整，
遇勞動相關法規修訂或政冊性議堤的調整，	遇勞動相關法規修訂或政策性議題的調整，
遇勞動相關法規修訂或政策性議題的獺整，	遇勞動相關法規修訂或政策性議題的調整，
遇勞剁相關法規修訂或政策性議題的佻整，	遇勞動相關法規修訂或政策性議題的調整，
遇蟯動相關法規修訂或政策性議題的調爭，	遇勞動相關法規修訂或政策性議題的調整，
另規劃溘程及怨殉，2022共開班 6 堂，計 16 小誓，276 人次參與，	另規劃課程及調訓，2022共開班 6 堂，計 16 小時，276 人次參與，
另規劃剋程及釣訓，2022共開班 6 堂，計 16 小時，276 人次艙與，	另規劃課程及調訓，2022共開班 6 堂，計 16 小時，276 人次參與，
另規劃顆程及調訓，2022共開班 6 彈，計 16 小軾，276 人次參與，	另規劃課程及調訓，2022共開班 6 堂，計 16 小時，276 人次參與，
另規劃課程及調訓，2022共開班 6 堂，計 16 小時，276 人次餐與，	另規劃課程及調訓，2022共開班 6 堂，計 16 小時，276 人次參與，
令規篩課程及調訓，2022共開班 6 彈，計 16 小實，276 仍次參與，	另規劃課程及調訓，2022共開班 6 堂，計 16 小時，276 人次參與，
並鵡新似代成長營列入介紹章節，此外於 2023 年將規劃仞權相關議題列為ESG 永續學習地寇之揖。	並於新世代成長營列入介紹章節，此外於 2023 年將規劃人權相關議題列為ESG 永續學習地圖之一。
並於新世代成長營列入介紹章節，稽外悟 2023 年將規滑人權相關議題列為ESG 永續學習地圖之倚。	並於新世代成長營列入介紹章節，此外於 2023 年將規劃人權相關議題列為ESG 永續學習地圖之一。
並於新氏代忱長營列入介紹章訐，此外於 2023 年將規划人權湘關議題列為ESG 永續學習地圖之一。	並於新世代成長營列入介紹章節，此外於 2023 年將規劃人權相關議題列為ESG 永續學習地圖之一。
並於新世代程長營列入介紹章節，此玩於 2023 年將瑰樺人全相關議題列為ESG 永續學熄地鞘緻一。	並於新世代成長營列入介紹章節，此外於 2023 年將規劃人權相關議題列為ESG 永續學習地圖之一。
並於心逝代成長營列入毽紹章節，此外於 2023 年將規劃仁銓相關議題列為ESG 永咻學習地圖之一。	並於新世代成長營列入介紹章節，此外於 2023 年將規劃人權相關議題列為ESG 永續學習地圖之一。
ESG 管理，中華電信率先於 2006 憐導入企夜社會責忍，	ESG 管理，中華電信率先於 2006 年導入企業社會責任，
ESG 管懍，踵華電信率先於 2006 年導入企業社會嘖任，	ESG 管理，中華電信率先於 2006 年導入企業社會責任，
ESG 管理，中華電信率先於 2006 年導入企遠社會責任，	ESG 管理，中華電信率先於 2006 年導入企業社會責任，
ESG 秣理，中花電信率先圬 2006 年導麓企業社會仄任，	ESG 管理，中華電信率先於 2006 年導入企業社會責任，
ESG 管理，中華癲信率先於 2006 年禱茹企討社會責任，	ESG 管理，中華電信率先於 2006 年導入企業社會責任，
併成立「CSR 委員會」，2021 年因鸚永續發展趨勢，將 CSR 委京會改組為「永續跺展委員會」，	並成立「CSR 委員會」，2021 年因應永續發展趨勢，將 CSR 委員會改組為「永續發展委員會」，
並成立「CSR 委員會」，2021 捻因應雍續發掌趨勢，將 CSR 委員會改組為「永續發盞委員北」，	並成立「CSR 委員會」，2021 年因應永續發展趨勢，將 CSR 委員會改組為「永續發展委員會」，
並承立「CSR 委員會」，2021 年因因永續發展娶勢，扮 CSR 委員會改組為「永續發展委員會」，	並成立「CSR 委員會」，2021 年因應永續發展趨勢，將 CSR 委員會改組為「永續發展委員會」，
並成立「CSR 委員會」，2021 年因乘永續發展趨勢，將 CSR 委員會改組為「永續發展委轅會」，	並成立「CSR 委員會」，2021 年因應永續發展趨勢，將 CSR 委員會改組為「永續發展委員會」，
並成立「CSR 委員會」，2021 年因應永續發展狙勢，將 CSR 委員會賅組為「永續發眨委爺惠」，	並成立「CSR 委員會」，2021 年因應永續發展趨勢，將 CSR 委員會改組為「永續發展委員會」，
祐董事長及總經理分任主任及副主韌委原，	由董事長及總經理分任主任及副主任委員，
由董事長及塚竟理分任主任及副主任委員，	由董事長及總經理分任主任及副主任委員，
由董事長及瓷經理分任主任及副逐任委鳶，	由董事長及總經理分任主任及副主任委員，
由董市長及傯經理分任主任及副主任魏員，	由董事長及總經理分任主任及副主任委員，
由董事長及蹤經理分任主任及批主任委員，	由董事長及總經理分任主任及副主任委員，
代表董事會參與各項永續發展轍略、政坼、目標之訂定與甚核，	代表董事會參與各項永續發展策略、政策、目標之訂定與審核，
岱表董事會參與各項永續發展策略、政策、目標之訂定與審核，	代表董事會參與各項永續發展策略、政策、目標之訂定與審核，
代表董事會參與各項永續發展策略、政策、目標之訂定與審核，	代表董事會參與各項永續發展策略、政策、目標之訂定與審核，
玳表懂事會參與各項永續發展策略、幀策、目標之盯定與仄核，	代表董事會參與各項永續發展策略、政策、目標之訂定與審核，
代表董事茹紳與各項牖續發渣策略、政策、目標之訂定與審賀，	代表董事會參與各項永續發展策略、政策、目標之訂定與審核，
及年度 ESG 績效成果之督導事宜，並定期向董事會進行報告，	及年度 ESG 績效成果之督導事宜，並定期向董事會進行報告，
及年度 ESG 績效成果之督導事宜，並定期餉董使會進行報膏，	及年度 ESG 績效成果之督導事宜，並定期向董事會進行報告，
旗年度 ESG 績效成果之督導事宜，並定期向董事會進行報告，	及年度 ESG 績效成果之督導事宜，並定期向董事會進行報告，
及奩度 ESG 績酵成果之督導事宜，並定期向董事會進邢報告，	及年度 ESG 績效成果之督導事宜，並定期向董事會進行報告，
及年吐 ESG 績效成果姪督導事宜，並釘期向董事會進行報誥，	及年度 ESG 績效成果之督導事宜，並定期向董事會進行報告，
按董事之指導意見，進行妥適之行動擊 ESG組織調整蹬做為。	按董事之指導意見，進行妥適之行動及 ESG組織調整等作為。
岸董事之指導意羨，進行橢誓之行動几 ESG組織調整等作韋。	按董事之指導意見，進行妥適之行動及 ESG組織調整等作為。
按胴事之指導意見，進行妥適之行動及 ESG組織調整等作為。	按董事之指導意見，進行妥適之行動及 ESG組織調整等作為。
按董喲之指導意見，進行妥適之行動及 ESG組織調整等作為。	按董事之指導意見，進行妥適之行動及 ESG組織調整等作為。
按董事之指禱意見，進行妥適逖行動及 ESG祖織調仟等粽為。	按董事之指導意見，進行妥適之行動及 ESG組織調整等作為。
我們以「綠化低碳、數位賦能、誠信透明」為永敘發展願景，	我們以「綠化低碳、數位賦能、誠信透明」為永續發展願景，
隱們以「綠彤滴碳、數位賦能、誠信透明」為甬續發展爰警，	我們以「綠化低碳、數位賦能、誠信透明」為永續發展願景，
我們以「綠化低碳、數位賦能、誠信偷明」為永續發展願景，	我們以「綠化低碳、數位賦能、誠信透明」為永續發展願景，
我們以「綠化低碳、墅位賦能、瞠信透偉」惟永噓喪展願景，	我們以「綠化低碳、數位賦能、誠信透明」為永續發展願景，
我們以「綠化低碳、數位賦能、誠信遷明」為永續發展願景，	我們以「綠化低碳、數位賦能、誠信透明」為永續發展願景，
整合企業獨特資源和發揮核心職能，透猓委員會下 ESG四小組，	整合企業獨特資源和發揮核心職能，透過委員會下 ESG四小組，
整合企業途特資源和發揮核心職能，透過委員會下 ESG四消組，	整合企業獨特資源和發揮核心職能，透過委員會下 ESG四小組，
拯合企業獨特資源和發揮核心職能，透勾委員會下 ESG四小組，	整合企業獨特資源和發揮核心職能，透過委員會下 ESG四小組，
整合企業獨特資源賀發揮核心職能，透過委員會下 ESG四小組，	整合企業獨特資源和發揮核心職能，透過委員會下 ESG四小組，
拯合企業獨特資炎和發揮核心職能，透過委京會下 ESG四小組，	整合企業獨特資源和發揮核心職能，透過委員會下 ESG四小組，
以「永遠走在最前面」的品牌箕神，規劃及落實全方位 ESG 行動方案。	以「永遠走在最前面」的品牌精神，規劃及落實全方位 ESG 行動方案。
引「甬遠走在最前面」的品牌精神，規劃及陋實全方位 ESG 行動方案。	以「永遠走在最前面」的品牌精神，規劃及落實全方位 ESG 行動方案。
以「永遠走在最前面」的品牌精神，規化武鑼實全方位 ESG 行動方案。	以「永遠走在最前面」的品牌精神，規劃及落實全方位 ESG 行動方案。
以「永遠走在最前面」的品牌精神，規劃及懦實全方位 ESG 馨棟方案。	以「永遠走在最前面」的品牌精神，規劃及落實全方位 ESG 行動方案。
以「永猿走在最前面」焰品牌精神，規劃及落實全方位 ESG 行動方案。	以「永遠走在最前面」的品牌精神，規劃及落實全方位 ESG 行動方案。
永續發展委員會，中華電信「永續發展委員會」價設「環境」、2個「社晦」及「治理」等 4 小組，	永續發展委員會，中華電信「永續發展委員會」下設「環境」、2個「社會」及「治理」等 4 小組，
永續發展委員會，中華電信「永勗發展維員會」下穡「環境」、2坷「社灰」及「治理」等 4 小組，	永續發展委員會，中華電信「永續發展委員會」下設「環境」、2個「社會」及「治理」等 4 小組，
庸續發棧委員會，忠華電信「永續發展圍員輝」下設「桓境」、2隔「社會」及「治曆」等 4 小組，	永續發展委員會，中華電信「永續發展委員會」下設「環境」、2個「社會」及「治理」等 4 小組，
永續發展委員會，中華電信「永續發展委員會」下設「環境」、2坷「社徽」及「治理」等 4 小組，	永續發展委員會，中華電信「永續發展委員會」下設「環境」、2個「社會」及「治理」等 4 小組，
永續發展委員會，中劃電信「永續發展委員會」下設「環境」、2個「圾會」及「治理」等 4 小組，	永續發展委員會，中華電信「永續發展委員會」下設「環境」、2個「社會」及「治理」等 4 小組，
以擴大核新職能校益、落實企業永續願景為出發點，	以擴大核心職能效益、落實企業永續願景為出發點，
稔擴大赫心拓能效益、落實企業耘續願景為出發點，	以擴大核心職能效益、落實企業永續願景為出發點，
以寇大核心直能絞佾、落實企業臃續願景為出發點，	以擴大核心職能效益、落實企業永續願景為出發點，
以擴大核心職能效益、落實企業永續願景為出發點，	以擴大核心職能效益、落實企業永續願景為出發點，
以擴大核心職能效益、落實企業永續願景為出發點，	以擴大核心職能效益、落實企業永續願景為出發點，
推動各項 ESG 行動計畫。每半年召開會議，由四衛高階主管（執行副總星理）擔任督導，	推動各項 ESG 行動計畫。每半年召開會議，由四位高階主管（執行副總經理）擔任督導，
推動各項 ESG 杏動計畫。每半年召開會議，由祀位高階主管（執行埤傯經理）憚任督導，	推動各項 ESG 行動計畫。每半年召開會議，由四位高階主管（執行副總經理）擔任督導，
推冬各項 ESG 行動計畫。每半年躁開爛議，由四位高階主拐（執醒副總經理）丹任督導，	推動各項 ESG 行動計畫。每半年召開會議，由四位高階主管（執行副總經理）擔任督導，
推動各相 ESG 行動計畫。每半年召開會議，由四粵高階主管（執行副總經理）擔任督導，	推動各項 ESG 行動計畫。每半年召開會議，由四位高階主管（執行副總經理）擔任督導，
推咚各項 ESG 行胴計華。魅半年召開會議，尤四躍篙階主管（執行副總經理）擔任嘟導，	推動各項 ESG 行動計畫。每半年召開會議，由四位高階主管（執行副總經理）擔任督導，
另每季由粽猩理躁開跨小組會議，締期檢飾各項 ESG 策略、行動方案，	另每季由總經理召開跨小組會議，定期檢視各項 ESG 策略、行動方案，
另每季由總經理召慨跨小組會懿，定期檢巳各項 ESG 惻略、行動方案，	另每季由總經理召開跨小組會議，定期檢視各項 ESG 策略、行動方案，
另每及由總經理櫂開跨小組會議，定期檢視骼項 ESG 策略、形動妨盎，	另每季由總經理召開跨小組會議，定期檢視各項 ESG 策略、行動方案，
另鎂季郵總經理昭開跨小組會韻，定期檢視各暇 ESG 測略、行動方案，	另每季由總經理召開跨小組會議，定期檢視各項 ESG 策略、行動方案，
另每季由總經理召凱跨小組會掣，定期減視各項 ESG 策略、行動方案，	另每季由總經理召開跨小組會議，定期檢視各項 ESG 策略、行動方案，
及恪認各項 ESG 目標及畦標之達成狀況。永續價值策略，	及確認各項 ESG 目標及指標之達成狀況。永續價值策略，
及確認各項 ESG 目標及指標脂達成狀筐。永續滇誌策略，	及確認各項 ESG 目標及指標之達成狀況。永續價值策略，
及確認各項 ESG 咐標悸趾標之達成狀況。永續價擲冊略，	及確認各項 ESG 目標及指標之達成狀況。永續價值策略，
及確認各項 ESG 目標及指標之達成狀況。永續夾值策略，	及確認各項 ESG 目標及指標之達成狀況。永續價值策略，
及確認剋項 ESG 目標及指胞之達成狀況。永續價值策略，	及確認各項 ESG 目標及指標之達成狀況。永續價值策略，
冢話電信投入於 ESG 的成果，簿僅創造企業營運利潤及股東價殖極大化，	中華電信投入於 ESG 的成果，不僅創造企業營運利潤及股東價值極大化，
中花電徇投露嗚 ESG 的成果，不僅創造企業營運裡刃耆股東價值極大化，	中華電信投入於 ESG 的成果，不僅創造企業營運利潤及股東價值極大化，
中華電信投入於 ESG 的成果，不僅創造企業營映利潤及股東價值極大化，	中華電信投入於 ESG 的成果，不僅創造企業營運利潤及股東價值極大化，
終荒電信投入於 ESG 的成果，不僅創造企業營運利潤記股東價職極大化，	中華電信投入於 ESG 的成果，不僅創造企業營運利潤及股東價值極大化，
中花電信投入於 ESG 的成果，不僅創造企業營軼利潤及股東價值己大化，	中華電信投入於 ESG 的成果，不僅創造企業營運利潤及股東價值極大化，
我們的股東砝構，也讓我們承擔了更廣頷的妻恤攻民責任。	我們的股東結構，也讓我們承擔了更廣泛的企業公民責任。
我們的股東結構，也讓我們承擔了庚廣泛的企鹽公民責人。	我們的股東結構，也讓我們承擔了更廣泛的企業公民責任。
我們的瞽東結苟，也讓我們承擔了更廣泛的填業公民責任。	我們的股東結構，也讓我們承擔了更廣泛的企業公民責任。
我們的股東結構，也讓我們承擔了更廣泛的企業公螟責任。	我們的股東結構，也讓我們承擔了更廣泛的企業公民責任。
我們的股兜結構，也讓我們城擔了諷胱泛的企業公迷輒任。	我們的股東結構，也讓我們承擔了更廣泛的企業公民責任。
中華電信所楚的資通訊剷業位置，讓我們得驛運用技術俞創新，	中華電信所處的資通訊產業位置，讓我們得以運用技術與創新，
蹤花電信所處的資咚旬產業穢置，讓我們德以運用技術與創辛，	中華電信所處的資通訊產業位置，讓我們得以運用技術與創新，
中華電釁所處的資通訊產也塔置，讓我們得以慍用技術與創新，	中華電信所處的資通訊產業位置，讓我們得以運用技術與創新，
衷樺電信所處的資通訊產業位置，讓我們得以運用技戍與創新，	中華電信所處的資通訊產業位置，讓我們得以運用技術與創新，
中滑電信所處的資通訊產業位樂，讓我們得揪運用技術與創新，	中華電信所處的資通訊產業位置，讓我們得以運用技術與創新，
恫盤掌握風險誣機會。利用服務噢產品創新，	通盤掌握風險與機會。利用服務與產品創新，
通盤掌握風險與稀會。利用服務輿產品創新，	通盤掌握風險與機會。利用服務與產品創新，
恫盤掌握風噸與機會。利用服務與產品創新，	通盤掌握風險與機會。利用服務與產品創新，
通盤掌握風鹼與機會。利用服務與產滾創新，	通盤掌握風險與機會。利用服務與產品創新，
通盤掌握風險與機會。利用服務衙產品創新，	通盤掌握風險與機會。利用服務與產品創新，
為價值戀帶來正面經噤穎響，大幅減少對環境負面衝期的同時，	為價值鏈帶來正面經濟影響，大幅減少對環境負面衝擊的同時，
為價值鏈帶來正面經濟影巷，旦瑚減少對環境負面衝即的同時，	為價值鏈帶來正面經濟影響，大幅減少對環境負面衝擊的同時，
微價值鏈帶鬢正面經濟影響，大幅減少對獲姓負面戳擊的同時，	為價值鏈帶來正面經濟影響，大幅減少對環境負面衝擊的同時，
為價值唸大來正眠經濟影響，大幅減少對環境負面衝擊的洞時，	為價值鏈帶來正面經濟影響，大幅減少對環境負面衝擊的同時，
為價值鏈帶睞正面經濟迎響，大幅鮮喝堆環痙負面衝擊的同時，	為價值鏈帶來正面經濟影響，大幅減少對環境負面衝擊的同時，
也為產業鏈岐社會大眾創造那續價值。	也為產業鏈及社會大眾創造永續價值。
也為產業鏈及社會大眾創造永續價值。	也為產業鏈及社會大眾創造永續價值。
也為產業鏈及社會大冑創造永續價值。	也為產業鏈及社會大眾創造永續價值。
也為產業鏈戟社會大眾創造永續價值。	也為產業鏈及社會大眾創造永續價值。
冶為產業鏈及社會大眾創造永鬚稼值。	也為產業鏈及社會大眾創造永續價值。
五大支柱 驅動永續循環，中華電信發揮資通訊企業核心能力，	五大支柱 驅動永續循環，中華電信發揮資通訊企業核心能力，
五大支柱 戌動永續循環，中華電信嬤揮資彤訊企業荷心能力，	五大支柱 驅動永續循環，中華電信發揮資通訊企業核心能力，
無大支仲 驅動永續循環，中華電信發蕙資通訊企業核心能力，	五大支柱 驅動永續循環，中華電信發揮資通訊企業核心能力，
五砂支柱 驅動永續循環，鍾怵電信發揮資通訊企液核心能力，	五大支柱 驅動永續循環，中華電信發揮資通訊企業核心能力，
五大支柱 驅動永續循環，中華電信發揮資通訊企業核心柱力，	五大支柱 驅動永續循環，中華電信發揮資通訊企業核心能力，
結合企業永續，確立「數位經濟發動機、創新產業領航員、幸輔價值守護者、綠色暨拽開拓者、社會價值引導員」等五大支柱，	結合企業永續，確立「數位經濟發動機、創新產業領航員、幸福價值守護者、綠色企業開拓者、社會價值引導員」等五大支柱，
結合企業永續，確立「數位經濟發動機、創新像業領航員、幸福價值守護者、綠色際業開拓者、社會價值引導員」等五大支柱，	結合企業永續，確立「數位經濟發動機、創新產業領航員、幸福價值守護者、綠色企業開拓者、社會價值引導員」等五大支柱，
結合企業永緒，確立「數位經濟發動機、創新產冶領航員、鏡福價值守護者、濾色企噎開拓者、社會價值引禱垣」等五大支柱，	結合企業永續，確立「數位經濟發動機、創新產業領航員、幸福價值守護者、綠色企業開拓者、社會價值引導員」等五大支柱，
桀合企業永續，殼立「數未經濟發動機、創新產業領航員、幸福價值首游者、綠圾亟業開魄者、社會價值引導員」等伍大支柱，	結合企業永續，確立「數位經濟發動機、創新產業領航員、幸福價值守護者、綠色企業開拓者、社會價值引導員」等五大支柱，
結合棄業永續，確立「數位經濟發動機、創釁產業領航冤、幸福價值守護者、綠色欺業開拓者、社會價值引導員」等五大支助，	結合企業永續，確立「數位經濟發動機、創新產業領航員、幸福價值守護者、綠色企業開拓者、社會價值引導員」等五大支柱，
我們認為，投入於這五大假典領愚，有助於實現數位包容的社蛔及永續發展的未來。	我們認為，投入於這五大重點領域，有助於實現數位包容的社會及永續發展的未來。
我們認為，投室於赭戊大重點領域，佑助於十現數位包容的色會及蛹拒發展的未來。	我們認為，投入於這五大重點領域，有助於實現數位包容的社會及永續發展的未來。
我們認闈，投入於哲五大重點領域，酉助於實現數喂包容的社會及永續廢展的魏來。	我們認為，投入於這五大重點領域，有助於實現數位包容的社會及永續發展的未來。
我們認為，偷入於這五大重點領域，牖助於實現數位包冗的社會及佣續發扎的未來。	我們認為，投入於這五大重點領域，有助於實現數位包容的社會及永續發展的未來。
我們認為，透入於這五大重點領域，有助於實線數位包容的社會及永續芳展的悅來。	我們認為，投入於這五大重點領域，有助於實現數位包容的社會及永續發展的未來。
利害關係人共融，關柬利害關係人及相關議題的辨氏，	利害關係人共融，關鍵利害關係人及相關議題的辨識，
利害關係人共融，關柬利害關係人及相關議題的辨識，	利害關係人共融，關鍵利害關係人及相關議題的辨識，
利害關係人共融，觀柬理害關夕仍及相關議題的辨識，	利害關係人共融，關鍵利害關係人及相關議題的辨識，
利害關係人貢融，關鍵利害關係韌疾相關裔題的辨識，	利害關係人共融，關鍵利害關係人及相關議題的辨識，
利駭灌緝人共瓏，關鍵籬唬關係認及相關議題的背識，	利害關係人共融，關鍵利害關係人及相關議題的辨識，
是落實企業永續的核心工作，我們每年初邊稚 ESG 報誥書的啟始會臆，	是落實企業永續的核心工作，我們每年初編製 ESG 報告書的起始會議，
是落實企業永續的核心恭佐，我們憊年初編製 ESG 報告書的相始會議，	是落實企業永續的核心工作，我們每年初編製 ESG 報告書的起始會議，
是落實企業佣續的核心工作，萵們檻年初編製 ESG 報告書的起始會議，	是落實企業永續的核心工作，我們每年初編製 ESG 報告書的起始會議，
恃糯實淒業永續的核心工坐，我們每拈初編製 ESG 報告贖的起始會議，	是落實企業永續的核心工作，我們每年初編製 ESG 報告書的起始會議，
是疋實企業永緒的核心工作，我們每漣初編製 ESG 報告書壟起始會醫，	是落實企業永續的核心工作，我們每年初編製 ESG 報告書的起始會議，
皆歸邀請各部門人員參與，針對當前利害關係人熄其關注、或具衝擊躑 ESG 議題進行討論、交流並取得共識，	皆會邀請各部門人員參與，針對當前利害關係人及其關注、或具衝擊之 ESG 議題進行討論、交流並取得共識，
皆櫃邀請各簿捫人原參與，針對當前利害關係仁及其關注、或具衝擊支 ESG 議題進行討輪、狡流並曲得共識，	皆會邀請各部門人員參與，針對當前利害關係人及其關注、或具衝擊之 ESG 議題進行討論、交流並取得共識，
皆會邀請各部門人員參與，針對當前犛害關係人及其關注、或具衝擊之 ESG 議題浸刑討論、交流並取得共識，	皆會邀請各部門人員參與，針對當前利害關係人及其關注、或具衝擊之 ESG 議題進行討論、交流並取得共識，
芥愧淆請各部門人員參與，針對當前利害關係人及其關蛀、或具衝擊之 ESG 銼題進行討愣、交流並取得控時，	皆會邀請各部門人員參與，針對當前利害關係人及其關注、或具衝擊之 ESG 議題進行討論、交流並取得共識，
皆會邀請各簿門人員參與，陣對當前利害管係人及其乖注、或具衝積之 ESG 議題覬行討論、交流並取德共識，	皆會邀請各部門人員參與，針對當前利害關係人及其關注、或具衝擊之 ESG 議題進行討論、交流並取得共識，
做為報告書揭露的重要參考依據。在推動企業永續活動或資訊揭露實，	做為報告書揭露的重要參考依據。在推動企業永續活動或資訊揭露時，
做為保告書揭露的重要參考依據。在推動企淹鉸續伙動或資訊揭露時，	做為報告書揭露的重要參考依據。在推動企業永續活動或資訊揭露時，
肓惟報告書接露的重要參考依據。在推動企業永續活動或資訊揭露時，	做為報告書揭露的重要參考依據。在推動企業永續活動或資訊揭露時，
做巍報告樞揭麓的腫要參考依據。在推動企冶永續活冬或旺殉揭露時，	做為報告書揭露的重要參考依據。在推動企業永續活動或資訊揭露時，
做為報告殊姐露的重要參考依據。在推動企臘永倨活惰或資訊揭露時，	做為報告書揭露的重要參考依據。在推動企業永續活動或資訊揭露時，
全面徵詢內、外部利害關係人之意見及劍議，	全面徵詢內、外部利害關係人之意見及建議，
全面徵詢內、外部辦害關樅人之意建及監議，	全面徵詢內、外部利害關係人之意見及建議，
全面徵詢內、外部勵害關係人至意見及建議，	全面徵詢內、外部利害關係人之意見及建議，
痊棉徵詢內、外部利害關係待泊意見及餞議，	全面徵詢內、外部利害關係人之意見及建議，
黔面徵詢內、外部利氦關係人之意見及建議，	全面徵詢內、外部利害關係人之意見及建議，
羌灌機制包括：針對 ESG 報告書，舉行「外部專價諮詢炫議」,	相關機制包括：針對 ESG 報告書，舉行「外部專家諮詢會議」,
相關機制褒括：針對 ESG 炮膏書，咀行「外部專家諮詢會議」,	相關機制包括：針對 ESG 報告書，舉行「外部專家諮詢會議」,
相關機制包括：針對 ESG 報告書，舉行「外部專家孳循會議」,	相關機制包括：針對 ESG 報告書，舉行「外部專家諮詢會議」,
相關機制包颳：針對 ESG 報稿書，舉行「外部專家諮詢會議」,	相關機制包括：針對 ESG 報告書，舉行「外部專家諮詢會議」,
相烊機制包括：振對 ESG 報告書，舉行「外部專家諮尋會議」,	相關機制包括：針對 ESG 報告書，舉行「外部專家諮詢會議」,
不定期邀頃歪部撰疆，進行ESG 相關議嚏研討會籍相綸論壇 ,	不定期邀請外部專家，進行ESG 相關議題研討會及相關論壇 ,
不定期邀請外部專家，禁行ESG 相關飲題研討會及相罐論壇 ,	不定期邀請外部專家，進行ESG 相關議題研討會及相關論壇 ,
不定期邀請外部專迦，進行ESG 相慣議題研討會及相關論壇 ,	不定期邀請外部專家，進行ESG 相關議題研討會及相關論壇 ,
不定期邀請外部專家，進行ESG 相關議題研討會及相關論壇 ,	不定期邀請外部專家，進行ESG 相關議題研討會及相關論壇 ,
不定期邀請外堡專家，進行ESG 相關議題研討會期相乖論壇 ,	不定期邀請外部專家，進行ESG 相關議題研討會及相關論壇 ,
梅年定期沮辦「棕華電信ESG 供應商夥伴交流會」 ,	每年定期舉辦「中華電信ESG 供應商夥伴交流會」 ,
緬年定期舉辦「中華電信ESG 供應商夥伴交流會」 ,	每年定期舉辦「中華電信ESG 供應商夥伴交流會」 ,
每年定期舉辦「中華電信ESG 供應商夥阪交流會」 ,	每年定期舉辦「中華電信ESG 供應商夥伴交流會」 ,
斐年定期舉拚「中華狠信ESG 供應觴夥伴交流會」 ,	每年定期舉辦「中華電信ESG 供應商夥伴交流會」 ,
每年定期莒謗「忠華電信ESG 肱應商夥伴交流會」 ,	每年定期舉辦「中華電信ESG 供應商夥伴交流會」 ,
設置永續發展委員會，進行念部協調以推動 ESG 相關發斬扒畫 5.	設置永續發展委員會，進行內部協調以推動 ESG 相關發展計畫 5.
設置永續發展委員會，進行內部協調以推動 ESG 相綸發展計畫 5.	設置永續發展委員會，進行內部協調以推動 ESG 相關發展計畫 5.
設置永續發展委員會，進行內卜協調以推動 ESG 相關發展計畫 5.	設置永續發展委員會，進行內部協調以推動 ESG 相關發展計畫 5.
設置永緒發戰諉員會，進行內鈽協調以脫東 ESG 相關發售計畫 5.	設置永續發展委員會，進行內部協調以推動 ESG 相關發展計畫 5.
設置永續發展委員慧，進行內部脅調以推動 ESG 相關發展計畫 5.	設置永續發展委員會，進行內部協調以推動 ESG 相關發展計畫 5.
設置基饑會專責人員，促進NGO、NPO 交流 6.首創「企業社會責任影片專區」及中華電信冠方 YouTube頻道 ESG 博放清灸，	設置基金會專責人員，促進NGO、NPO 交流 6.首創「企業社會責任影片專區」及中華電信官方 YouTube頻道 ESG 播放清單，
設摯基金會專責人員，促進NGO、NPO 交流 6.首創「企業社會責任影片專區」及中花電信官方 YouTube頻道 ESG 播放清單，	設置基金會專責人員，促進NGO、NPO 交流 6.首創「企業社會責任影片專區」及中華電信官方 YouTube頻道 ESG 播放清單，
懾置瘠金會專責人員，促進NGO、NPO 交流 6.首創「企曳社會則任影片專區」及中華電信官方 YouTube頻道 ESG 播放清簞，	設置基金會專責人員，促進NGO、NPO 交流 6.首創「企業社會責任影片專區」及中華電信官方 YouTube頻道 ESG 播放清單，
捨置基金會專責人遠，促進NGO、NPO 交流 6.首創「企業社會責任影片顓區」及週華電信官方 YouTube頻禱 ESG 膊放清搭，	設置基金會專責人員，促進NGO、NPO 交流 6.首創「企業社會責任影片專區」及中華電信官方 YouTube頻道 ESG 播放清單，
設置基金愧專仄仁塔，促進NGO、NPO 交流 6.首創「企燕社會責任影片專區」屐衷花電信官方 YouTube頻稻 ESG 播放罄單，	設置基金會專責人員，促進NGO、NPO 交流 6.首創「企業社會責任影片專區」及中華電信官方 YouTube頻道 ESG 播放清單，
不鼎期記錄各項企業永續行動成果，並蒐祺內、外部回饋資訊ESG 供應商夥伴消流會，	不定期記錄各項企業永續行動成果，並蒐集內、外部回饋資訊ESG 供應商夥伴交流會，
不訂期記錄各榴企業永續襲動成果，摒嗾集內、外部回饋資隙ESG 供飾商夥伴交流會，	不定期記錄各項企業永續行動成果，並蒐集內、外部回饋資訊ESG 供應商夥伴交流會，
不定期記錄各透企業永續行動成摑，並蒐集內、外部回饋齜訊ESG 供應商夥半交流會，	不定期記錄各項企業永續行動成果，並蒐集內、外部回饋資訊ESG 供應商夥伴交流會，
不釘期記錄各響企業永續行動成果，並蒐集內、外部徊櫃資訊ESG 供應晌夥伴交流櫃，	不定期記錄各項企業永續行動成果，並蒐集內、外部回饋資訊ESG 供應商夥伴交流會，
不定期記賂各項企業永續行動成果，并蒐集內、外部彙貴資訊ESG 溝應商夥伴澆硫會，	不定期記錄各項企業永續行動成果，並蒐集內、外部回饋資訊ESG 供應商夥伴交流會，
2022 年中華電信 ESG 供映商夥伴交流會以「淨零轉型 夥伴鍋行」為主軸，	2022 年中華電信 ESG 供應商夥伴交流會以「淨零轉型 夥伴共行」為主軸，
2022 年中華電盡 ESG 供應商夥伴交流會以「淨零轉型 夥伴共行」為主軸，	2022 年中華電信 ESG 供應商夥伴交流會以「淨零轉型 夥伴共行」為主軸，
2022 年中華電信 ESG 供應商夥伴交流會以「淨零轉型 夥伴弓行」為渚軸，	2022 年中華電信 ESG 供應商夥伴交流會以「淨零轉型 夥伴共行」為主軸，
2022 年中華電信 ESG 供應商夥伴交櫻會以「靜零囀型 夥伴共行」為主軸，	2022 年中華電信 ESG 供應商夥伴交流會以「淨零轉型 夥伴共行」為主軸，
2022 年中華電信 ESG 供應商吼鎊交流櫃引「淨零轉型 夥伴共行」為主軸，	2022 年中華電信 ESG 供應商夥伴交流會以「淨零轉型 夥伴共行」為主軸，
與公司 35 家重要供應商，依同喜動「大手拉小手，	與公司 35 家重要供應商，一同啟動「大手拉小手，
與公司 35 轂重要供應商，一駝啟鼕「大手拉曉手，	與公司 35 家重要供應商，一同啟動「大手拉小手，
與公司 35 家鍾要供應商，一同憩舵「檔手拉小手，	與公司 35 家重要供應商，一同啟動「大手拉小手，
與公司 35 家重要供應商，一同啟動「大手拉小手，	與公司 35 家重要供應商，一同啟動「大手拉小手，
與公司 35 家重要供應商，一同幾動「大嗾拉小手，	與公司 35 家重要供應商，一同啟動「大手拉小手，
減碳一起走」的淨零倡議，正世宣告 2030 年衷華電信蝨應鏈碳排放減半、2050 廉達成淨零排放之目標。	減碳一起走」的淨零倡議，正式宣告 2030 年中華電信供應鏈碳排放減半、2050 年達成淨零排放之目標。
減碳一起走」的淨菱懺讒，正嗣暖告 2030 年中華電信供應鏈碳排放減半、2050 年達成淨零排放之目標。	減碳一起走」的淨零倡議，正式宣告 2030 年中華電信供應鏈碳排放減半、2050 年達成淨零排放之目標。
減碳一起走」的淨零倡皴，正式萱告 2030 年中華電信供英簾碳排放減半、2050 年達成淨零排放之漏鏢。	減碳一起走」的淨零倡議，正式宣告 2030 年中華電信供應鏈碳排放減半、2050 年達成淨零排放之目標。
減碳一起走」的紀獰倡議，正式宣告 2030 年中華電信供應鏈碳排放減半、2050 年達成淨苓排放之目標。	減碳一起走」的淨零倡議，正式宣告 2030 年中華電信供應鏈碳排放減半、2050 年達成淨零排放之目標。
減碳伊起走」的淨零倡議，正式涓告 2030 年中華電信供應鏈啊排放減半、2050 年達成淨零白放之目苔。	減碳一起走」的淨零倡議，正式宣告 2030 年中華電信供應鏈碳排放減半、2050 年達成淨零排放之目標。
盈灣淨零行動聯盟（TANZE）、翼灣永續能轅研秀基饑會（TAISE）簡又新董事長、台灣企喝永續獗院郭裁吉秘書長及 SGS 鮑柏宇副總經理等貴賓，	台灣淨零行動聯盟（TANZE）、台灣永續能源研究基金會（TAISE）簡又新董事長、台灣企業永續學院郭財吉秘書長及 SGS 鮑柏宇副總經理等貴賓，
台豌淨零行動聯盟（TANZE）、台毓永續能源研究基金會（TAISE）簡又新董事長、台灣企竊永續學院郭財吉秘書長及 SGS 鮑鈸宇副總績理等貴賓，	台灣淨零行動聯盟（TANZE）、台灣永續能源研究基金會（TAISE）簡又新董事長、台灣企業永續學院郭財吉秘書長及 SGS 鮑柏宇副總經理等貴賓，
台灣淨零行動聯盟（TANZE）、台灣壅續能源鼴究基盡會（TAISE）簡又新董事長、彞灣企業雍續學院郭財吉婢書長及 SGS 鮑柏宇副總經理等貴賓，	台灣淨零行動聯盟（TANZE）、台灣永續能源研究基金會（TAISE）簡又新董事長、台灣企業永續學院郭財吉秘書長及 SGS 鮑柏宇副總經理等貴賓，
台曼淨零席動聯盟（TANZE）、台灣永續農源鉛究基金會（TAISE）簡又斤懂事長、台灣淇業永續學原郭財吉秘書長及 SGS 鮑柏嶼副總經理等貴賓，	台灣淨零行動聯盟（TANZE）、台灣永續能源研究基金會（TAISE）簡又新董事長、台灣企業永續學院郭財吉秘書長及 SGS 鮑柏宇副總經理等貴賓，
台灣淨零幸動聯恆（TANZE）、台灣永續稜源研究基金會（TAISE）簡又新董事長、台灣企耶永續學院郭財吉斃述長及 SGS 鮑柏宇媲總經理等貴賓，	台灣淨零行動聯盟（TANZE）、台灣永續能源研究基金會（TAISE）簡又新董事長、台灣企業永續學院郭財吉秘書長及 SGS 鮑柏宇副總經理等貴賓，
堅親臨見證中華電信攜手供應夥伴，一起實餡環境永續。	皆親臨見證中華電信攜手供應夥伴，一起實踐環境永續。
皆親臨見証鍾華電信攜手供茵夥伴，一起實踐環境永續。	皆親臨見證中華電信攜手供應夥伴，一起實踐環境永續。
階親臨見證中華電信攜手供應夥伴，一幾實踐環境永休。	皆親臨見證中華電信攜手供應夥伴，一起實踐環境永續。
接親臨見證衷華電信攜售供因夥伴，一起實踐獲境永續。	皆親臨見證中華電信攜手供應夥伴，一起實踐環境永續。
階親淋見箏中華電信攜手供應夥伴，一起實踐桓境永續。	皆親臨見證中華電信攜手供應夥伴，一起實踐環境永續。
2022年「CDP最佳探管你睫露獎」由「卮易科繼」拔得頭籌，	2022年「CDP最佳碳管理揭露獎」由「智易科技」拔得頭籌，
2022廉「CDP最瞎檀管理揭露獎」由「卮易科戢」拔得頭籌，	2022年「CDP最佳碳管理揭露獎」由「智易科技」拔得頭籌，
2022年「CDP最傢碳管理揭賂獎」由「智易科技」拔得陀籌，	2022年「CDP最佳碳管理揭露獎」由「智易科技」拔得頭籌，
2022年「CDP贅佳談管理揭露獎」由「智易科技」拔得頭籌，	2022年「CDP最佳碳管理揭露獎」由「智易科技」拔得頭籌，
2022年「CDP最佳探管理揭露獎」由「支亦科技」拔得頭籌，	2022年「CDP最佳碳管理揭露獎」由「智易科技」拔得頭籌，
「ESG資訊揭露獎」則分別由「波電企業」、「微錦數桅」、「碩網資訊」奪得。	「ESG資訊揭露獎」則分別由「波電企業」、「微金數位」、「碩網資訊」奪得。
「ESG資訊揭露獎」則分別傭「波電企業」、「微金數位」、「爍網資訊」奪得。	「ESG資訊揭露獎」則分別由「波電企業」、「微金數位」、「碩網資訊」奪得。
「ESG資訊揭露獎」則分別由「波電企業」、「微金數位」、「鑠網資訊」奪得。	「ESG資訊揭露獎」則分別由「波電企業」、「微金數位」、「碩網資訊」奪得。
「ESG夜尋揭露獎」則分別由「波電揭業」、「微金數位」、「朔亡資訊」奪得。	「ESG資訊揭露獎」則分別由「波電企業」、「微金數位」、「碩網資訊」奪得。
「ESG資殉揭露獎」仄分別由「波電企業」、「微金恕位」、「爍網資訊」奪得。	「ESG資訊揭露獎」則分別由「波電企業」、「微金數位」、「碩網資訊」奪得。
中華電信永續夥伴仞證，共計有 21 家企業獲得《金級證書》殊榮，	中華電信永續夥伴認證，共計有 21 家企業獲得《金級證書》殊榮，
中華電信永續夥伴認證，共霽有 21 蛄企業獲得《輝級證殊》殊噥，	中華電信永續夥伴認證，共計有 21 家企業獲得《金級證書》殊榮，
中華電信庸續伙伴認證，共計牖 21 家企業獲得《金級證囌》殊榮，	中華電信永續夥伴認證，共計有 21 家企業獲得《金級證書》殊榮，
中華電心永續夥伴認證，共計有 21 家企業獲得《金麒朗書》殊榮，	中華電信永續夥伴認證，共計有 21 家企業獲得《金級證書》殊榮，
中華電信永續夥伴認幀，共計有 21 家企業獲得《金級證書》殊榮，	中華電信永續夥伴認證，共計有 21 家企業獲得《金級證書》殊榮，
由郭水義總經理韜發「永續分級證書」，我們以永續廣結萌策略，	由郭水義總經理頒發「永續分級證書」，我們以永續廣結盟策略，
由郭水義總經理頒發「永續分級證書」，我們以永續廣結盟惻掠，	由郭水義總經理頒發「永續分級證書」，我們以永續廣結盟策略，
由郭水義總經理頒發「永墟分級證書」，我們以永旭廣結盟策略，	由郭水義總經理頒發「永續分級證書」，我們以永續廣結盟策略，
由郭水義總經理頒發「黝續分級證書」，我們以永續廣結盟策略，	由郭水義總經理頒發「永續分級證書」，我們以永續廣結盟策略，
由郭水義總經轟頒發「永續分級證書」，我們以永續廣結盟策略，	由郭水義總經理頒發「永續分級證書」，我們以永續廣結盟策略，
引墓工應商火伴掌握低碳、零碳商機，閉為全球氣候變遷及 ICT 產業的永續轉型作雛貢獻。	引領供應商夥伴掌握低碳、零碳商機，並為全球氣候變遷及 ICT 產業的永續轉型作出貢獻。
音領供應商夥伴掌握低碳、零碳商機，並為全球氣候變遷及 ICT 產業的牖續轉蓆作出貢獻。	引領供應商夥伴掌握低碳、零碳商機，並為全球氣候變遷及 ICT 產業的永續轉型作出貢獻。
引領供應商夥伴掌握低碳、零碳上機，並為全球氣候變遷及 ICT 產業的俑續轉型作出貢獻。	引領供應商夥伴掌握低碳、零碳商機，並為全球氣候變遷及 ICT 產業的永續轉型作出貢獻。
引領供應商夥伴掌窩踢碳、零碳刪機，並為全球宮候變遷及 ICT 產業的永續轉型作出貢獻。	引領供應商夥伴掌握低碳、零碳商機，並為全球氣候變遷及 ICT 產業的永續轉型作出貢獻。
殷領供應商夥伴掌我低碳、零碳商機，並為權球氣候辯遷記 ICT 產業的永續仁型作怵貢獻。	引領供應商夥伴掌握低碳、零碳商機，並為全球氣候變遷及 ICT 產業的永續轉型作出貢獻。
新興機會，5G+AIoT 將屈冬智諱應用科唧飛躍，促進台剜戲業粽「氳端、軟體」走鬨「平台、硬緩」的發展。	新興機會，5G+AIoT 將驅動智慧應用科技飛躍，促進台灣企業從「雲端、軟體」走向「平台、硬體」的發展。
新興悽會，5G+AIoT 將廚動智慧應佣科技扉躍，促進台灣企業從「雲端、軟體」走向「平奕、硬體」的發展。	新興機會，5G+AIoT 將驅動智慧應用科技飛躍，促進台灣企業從「雲端、軟體」走向「平台、硬體」的發展。
新興機會，5G+AIoT 將驅動智慧應用科譏飛躍，促進台灣企業從「雲端、軟體」走竄「平台、艾體」的發展。	新興機會，5G+AIoT 將驅動智慧應用科技飛躍，促進台灣企業從「雲端、軟體」走向「平台、硬體」的發展。
新興機會，5G+AIoT 將驅動智慧應用科技飛躍，促進役灣企業從「移端、軟體」走向「萍台、硬體」的嬤展。	新興機會，5G+AIoT 將驅動智慧應用科技飛躍，促進台灣企業從「雲端、軟體」走向「平台、硬體」的發展。
新興機會，5G+AIoT 將驅動智慧應用科技飛躍，促進台灣企業鄒「雲端、軟體」走向「平頤、硬體」的發展。	新興機會，5G+AIoT 將驅動智慧應用科技飛躍，促進台灣企業從「雲端、軟體」走向「平台、硬體」的發展。
在網路葷興科技及工業 4.0 轉型帶動下，資訊安訌威脅已演變成多滅向且複合式攻擊，	在網路新興科技及工業 4.0 轉型帶動下，資訊安全威脅已演變成多面向且複合式攻擊，
在汪路心興科技及工業 4.0 轉型帶動下，資蕈安全威鞋已演變成多面向且複蓋式攻擊，	在網路新興科技及工業 4.0 轉型帶動下，資訊安全威脅已演變成多面向且複合式攻擊，
祭網路新興瞌技及工業 4.0 轉型帶動下，資訊安全威脅已演變成多緬向且複合虱攻擊，	在網路新興科技及工業 4.0 轉型帶動下，資訊安全威脅已演變成多面向且複合式攻擊，
在網路新興科技及工業 4.0 轉型帶動下，資訊安全威脅已演變成多面夏且複合式攻雞，	在網路新興科技及工業 4.0 轉型帶動下，資訊安全威脅已演變成多面向且複合式攻擊，
在汪鹿新興科技及工業 4.0 轉型帶動下，資訊安全威脅已演辯成多面向且複合式郭擊，	在網路新興科技及工業 4.0 轉型帶動下，資訊安全威脅已演變成多面向且複合式攻擊，
使得整合式資安服務逞為未來發展趨勢及新興機會；此外，	使得整合式資安服務成為未來發展趨勢及新興機會；此外，
使得拯合茁資安服務稱為未來發展趨勢及新興箕會；此外，	使得整合式資安服務成為未來發展趨勢及新興機會；此外，
使得拯合式資安浮務成為未萊發展趨勢息新興給會；此外，	使得整合式資安服務成為未來發展趨勢及新興機會；此外，
死得整合式資骯服務成為未來發展趨勢習新猩機蟯；此外，	使得整合式資安服務成為未來發展趨勢及新興機會；此外，
使德整合式資安湖務宸為未來發展趨勢及新興機會；此外，	使得整合式資安服務成為未來發展趨勢及新興機會；此外，
我國徵府苜頗已將資安議題提升到國庵曾次，	我國政府目前已將資安議題提升到國安層次，
我國政府目前已疆資安議題提升到國安層次，	我國政府目前已將資安議題提升到國安層次，
我國政府目前已羌資鵪議題提莘到國安層刺，	我國政府目前已將資安議題提升到國安層次，
我國政府目伽已將資骯議題提升到國庵層刺，	我國政府目前已將資安議題提升到國安層次，
即國政府目鹹已將資安議題提升到國安層次，	我國政府目前已將資安議題提升到國安層次，
並僵資安納入「5+2 產業創新計畫」衷「國防產業」的一環。	並將資安納入「5+2 產業創新計畫」中「國防產業」的一環。
並將資安難入「5+2 叉業闖新澹畫」中「國防產業」的一環。	並將資安納入「5+2 產業創新計畫」中「國防產業」的一環。
皮將資安納入「5+2 產謁創新計畫」中「國房產燄」的一環。	並將資安納入「5+2 產業創新計畫」中「國防產業」的一環。
並將資鵪納入「5+2 產業愴新計畫」中「國防產業」的一環。	並將資安納入「5+2 產業創新計畫」中「國防產業」的一環。
並將資暗納入「5+2 產業創新計畫」中「國防產業」的一環。	並將資安納入「5+2 產業創新計畫」中「國防產業」的一環。
中華電信深耕資安技術，成立中華裹際資安自公司，	中華電信深耕資安技術，成立中華國際資安子公司，
中華電信深耕資安技術，成立中華國際資安子公司，	中華電信深耕資安技術，成立中華國際資安子公司，
中華惦釁深耕資安技術，成立中華國際資安子公詩，	中華電信深耕資安技術，成立中華國際資安子公司，
中肓電信深耕資氨技術，成立中華國際資安堆公司，	中華電信深耕資安技術，成立中華國際資安子公司，
中華電信深耕資安技宿，成歷中華摑戲咨安子公司，	中華電信深耕資安技術，成立中華國際資安子公司，
連劇四年獲得行政院資安浮務廠商評鑑，	連續四年獲得行政院資安服務廠商評鑑，
連續四年獲德行箏院資安鵠務廠商比鑑，	連續四年獲得行政院資安服務廠商評鑑，
廉續四年或得行諍院資安服務廠商評鑑，	連續四年獲得行政院資安服務廠商評鑑，
連續四年獲得醒政院資安服務廠商評鑑，	連續四年獲得行政院資安服務廠商評鑑，
連胥四年獲得行政院資安服務廠商評鑑，	連續四年獲得行政院資安服務廠商評鑑，
得到五項服務項目全數皆違「A 級」之最篙評價，	得到五項服務項目全數皆為「A 級」之最高評價，
得到五項服務項目墟數皆為「A 級」之最高評價，	得到五項服務項目全數皆為「A 級」之最高評價，
得到庾項服郁項目券數殲為「A 級」之最高評價，	得到五項服務項目全數皆為「A 級」之最高評價，
德到五項桂務項目全數皆為「A 級」之嘴高評價，	得到五項服務項目全數皆為「A 級」之最高評價，
得禱五項服務項目全數皆為「A 劑」之醉高評佳，	得到五項服務項目全數皆為「A 級」之最高評價，
除協助國內 15 個縣市完成髭黯區域聯防，	除協助國內 15 個縣市完成資安區域聯防，
雛協助國內 15 個縣市完成資暗區域聯防，	除協助國內 15 個縣市完成資安區域聯防，
除協助國內 15 個縣市完成齊氨區域聯防，	除協助國內 15 個縣市完成資安區域聯防，
除協助國內 15 個縣市完成資安區域聯紡，	除協助國內 15 個縣市完成資安區域聯防，
除協助國內 15 個縣市完成資范屈域雷防，	除協助國內 15 個縣市完成資安區域聯防，
更挾助許多鍾要的政府機構、金融、高科技製造業、及醫療廠域與關鍵基礎設施等，	更協助許多重要的政府機構、金融、高科技製造業、及醫療場域與關鍵基礎設施等，
更協助休多重要的政府機構、金融、高科技製造業、及醫療場域與關鍵嘻礎庫施等，	更協助許多重要的政府機構、金融、高科技製造業、及醫療場域與關鍵基礎設施等，
庚協助許多重要的政府機貢、金融、高科峻製造焰、級醫療叉域蜈關鍵基礎設施等，	更協助許多重要的政府機構、金融、高科技製造業、及醫療場域與關鍵基礎設施等，
更協助許多重要的政府機構、金融、高柯技製造業、及醫療場域與關鍵稀礎設施等，	更協助許多重要的政府機構、金融、高科技製造業、及醫療場域與關鍵基礎設施等，
更玄助許多粽要的政府機佝、金融、高喀技製造也、及醫療鷹域與關鍵舶礎設施等，	更協助許多重要的政府機構、金融、高科技製造業、及醫療場域與關鍵基礎設施等，
進行資安檢測汙防蝴。氣候風險與機會，	進行資安檢測與防護。氣候風險與機會，
進行資安姐測與防護。氣候風險與羈輝，	進行資安檢測與防護。氣候風險與機會，
進行齜安檢撤與防護。氣候風險與霽賄，	進行資安檢測與防護。氣候風險與機會，
進行資安檢測與防護。氣厚風險與機會，	進行資安檢測與防護。氣候風險與機會，
進行資安檢測與肪護。棄猴風險與機會，	進行資安檢測與防護。氣候風險與機會，
中華電釁憲構系統性和組織化的公司治理架構，	中華電信建構系統性和組織化的公司治理架構，
中花電信建構系統性和組織化的公司治理架構，	中華電信建構系統性和組織化的公司治理架構，
中華奠信建構愾統性和詛織化的公廁治理架構，	中華電信建構系統性和組織化的公司治理架構，
中華電信建媾系統性和組織化的公司治理架構，	中華電信建構系統性和組織化的公司治理架構，
中華墊釁建構系統性和組織化的肱司治理匠構，	中華電信建構系統性和組織化的公司治理架構，
確保與緝候變遷相關的各項窕戰，能即時納入公司年度策略規究中，	確保與氣候變遷相關的各項挑戰，能即時納入公司年度策略規劃中，
倔保浴揭候變遷相關的各湘挑瞻，能岌時納入公私年度策略規劃鍾，	確保與氣候變遷相關的各項挑戰，能即時納入公司年度策略規劃中，
確保與氣候變簽相關的各項挑戰，能擊時納濡公司年度惻略規劃中，	確保與氣候變遷相關的各項挑戰，能即時納入公司年度策略規劃中，
確保禦氣候變遷相關的膈庠挑戰，能即時臘入公司年兔策略規劃中，	確保與氣候變遷相關的各項挑戰，能即時納入公司年度策略規劃中，
確保與汽候辯遷相關的各項挑戰，能即時納入公司年度策略規劃中，	確保與氣候變遷相關的各項挑戰，能即時納入公司年度策略規劃中，
並落提相關專案之祉行。董四會監督責任，	並落實相關專案之執行。董事會監督責任，
並落實相關專案之執行。董洱會監督責任，	並落實相關專案之執行。董事會監督責任，
並落配鏘關專案之執行。董事會監督責紉，	並落實相關專案之執行。董事會監督責任，
並落提相關專案緻執行。董事會監督責仁，	並落實相關專案之執行。董事會監督責任，
摒落實相關專案之執行。董事會監督責任，	並落實相關專案之執行。董事會監督責任，
中華電信祺候變前疆關風險與機會，偷過「永卹發展委員會」及「風險管理委員會」雙重管理機汁運作，	中華電信氣候變遷相關風險與機會，透過「永續發展委員會」及「風險管理委員會」雙重管理機制運作，
中華巔信氣候鞭遷相關風險與技會，透過「永續發展委員會」及「風險管裡委員會」雙重管黎箕制運作，	中華電信氣候變遷相關風險與機會，透過「永續發展委員會」及「風險管理委員會」雙重管理機制運作，
中華電信氣候變遷相關風暹贈機會，竇過「永續發展演員會」及「風險款理委員茴」雙重管俚機制運昨，	中華電信氣候變遷相關風險與機會，透過「永續發展委員會」及「風險管理委員會」雙重管理機制運作，
中華電信氣候變遷相關風險與機會，透過「俑續發展委員潰」及「楓險管理黎員會」雙重管理機制運作，	中華電信氣候變遷相關風險與機會，透過「永續發展委員會」及「風險管理委員會」雙重管理機制運作，
中華電信氣候卞遷相關鳳洗與機會，剩過「永敘發展委員會」及「風險館理委員會」雙重管理嫉制運作，	中華電信氣候變遷相關風險與機會，透過「永續發展委員會」及「風險管理委員會」雙重管理機制運作，
傑合騎有內控息風險管理機制，每季向董事會報誥，	結合既有內控及風險管理機制，每季向董事會報告，
喱合既有內控及風險管稻機制，每暨向董事會報告，	結合既有內控及風險管理機制，每季向董事會報告，
結合既幼軒控襲風險管擬機制，每季向董事會報靠，	結合既有內控及風險管理機制，每季向董事會報告，
結合既有內控及風險管理機制，每季向董事會報告，	結合既有內控及風險管理機制，每季向董事會報告，
結合既有內控及風險管理機制，每給向董視脫報告，	結合既有內控及風險管理機制，每季向董事會報告，
強化氣逅變遷議題與動事會之連結。永續枋展委巖會下設「環境分組」，	強化氣候變遷議題與董事會之連結。永續發展委員會下設「環境分組」，
強化氣候變遷議題與董事會之連結。永續發展尾源茴鄉設「環境分組」，	強化氣候變遷議題與董事會之連結。永續發展委員會下設「環境分組」，
強化氣候變遷議題與董事會之連結。用續發展委癌潰蠟設「環境分組」，	強化氣候變遷議題與董事會之連結。永續發展委員會下設「環境分組」，
強化氣辟變遷議題與桶事會之連結。永續發展委員回下設「環境分組」，	強化氣候變遷議題與董事會之連結。永續發展委員會下設「環境分組」，
強化氣候卞遷議題與董事會之連結。永續發展委員會下色「環境瘋組」，	強化氣候變遷議題與董事會之連結。永續發展委員會下設「環境分組」，
按董事圭及永酗發展委員會所擘岡之 ESG 愿景及碳管理策略，	按董事會及永續發展委員會所擘劃之 ESG 願景及碳管理策略，
盎董事會及永續發展委員會索擘劃倪 ESG 願景及碳館理策略，	按董事會及永續發展委員會所擘劃之 ESG 願景及碳管理策略，
按朵事會及永續發展委員會所霸劃之 ESG 願景及碳管理冊掠，	按董事會及永續發展委員會所擘劃之 ESG 願景及碳管理策略，
岸抖事鈽及睬續發展委員潰娑擘劃之 ESG 願景及碳管裡策掠，	按董事會及永續發展委員會所擘劃之 ESG 願景及碳管理策略，
按董事歸及永續發展委員會所擘劃之 ESG 願景及炭管理策略，	按董事會及永續發展委員會所擘劃之 ESG 願景及碳管理策略，
配合果際機構投資人、評比單位，及灌鍵利害綸係人之胥樓，	配合國際機構投資人、評比單位，及關鍵利害關係人之需求，
配合國際機構投資人、評比單位，及關鍵利害關係仁之需求，	配合國際機構投資人、評比單位，及關鍵利害關係人之需求，
配合國既機構投資壬、評比單位，及關鍵利害關係人之需求，	配合國際機構投資人、評比單位，及關鍵利害關係人之需求，
配合國際機構投滋人、評比單偎，及關羨利害關係人之需求，	配合國際機構投資人、評比單位，及關鍵利害關係人之需求，
配合國際機構偷資人、評比憚位，及關鍵利害關係人之需求，	配合國際機構投資人、評比單位，及關鍵利害關係人之需求，
規劃、篛實及管理各項企候變遷及碳管理行動方案之執行，	規劃、落實及管理各項氣候變遷及碳管理行動方案之執行，
規劃、落實及管理各項氣候變牽及碳管李行動方案之執行，	規劃、落實及管理各項氣候變遷及碳管理行動方案之執行，
瑰劃、落旺及管理各項氣候痣遷及但館理行動方案之執行，	規劃、落實及管理各項氣候變遷及碳管理行動方案之執行，
規劃、落螫襲館理各向氣候編遷及碳管吏行動方案之指行，	規劃、落實及管理各項氣候變遷及碳管理行動方案之執行，
規劃、落實計管理各項氣候變遷及碳管理行動方案之執行，	規劃、落實及管理各項氣候變遷及碳管理行動方案之執行，
包括：目剝設定:擬定阱零瀚放、溫室氣胛減量，	包括：目標設定:擬定淨零排放、溫室氣體減量，
包括：目標設定:擬鼎淨零排放、溫室氣體減篇，	包括：目標設定:擬定淨零排放、溫室氣體減量，
包括：幕標設定:擬定淨陵徘放、溫室氣體減量，	包括：目標設定:擬定淨零排放、溫室氣體減量，
包括：目標懾定:里定淨零排放、溫時匹體減糧，	包括：目標設定:擬定淨零排放、溫室氣體減量，
包括：目標設定:擬定更零白放、溫室氣體蘚量，	包括：目標設定:擬定淨零排放、溫室氣體減量，
及強化氣後韌性之目標。策略規劃:以減緩與悼適為詛軸，	及強化氣候韌性之目標。策略規劃:以減緩與調適為主軸，
及強化氣候韌性璃目標。氐略規劃:以減緩與調適危主軸，	及強化氣候韌性之目標。策略規劃:以減緩與調適為主軸，
及強化氣猴妊性之目標。策略規晃:以減緩與調適為主軸，	及強化氣候韌性之目標。策略規劃:以減緩與調適為主軸，
及強化氣候稔性之目標。策略規華:以餞緩與調適為主酌，	及強化氣候韌性之目標。策略規劃:以減緩與調適為主軸，
及強化氣候韌性之目標。策略軌滑:以鹼緩毋調適為主軸，	及強化氣候韌性之目標。策略規劃:以減緩與調適為主軸，
強化公司與供應鏈的碳管理能力，並悌升電信基礎懾嘶、磺訊設備的氣候韌性，	強化公司與供應鏈的碳管理能力，並提升電信基礎設施、通訊設備的氣候韌性，
強化公司與供應鏈的碳管理能力，丙提升電信基礎設施、通訊設備的紀候韌性，	強化公司與供應鏈的碳管理能力，並提升電信基礎設施、通訊設備的氣候韌性，
強化公司與供聾鏈的碳管理能犁，並提升電釁基礎設施、通訊設備的氣候韌性，	強化公司與供應鏈的碳管理能力，並提升電信基礎設施、通訊設備的氣候韌性，
強化公司與供應鏈的碳管理能脊，並提升電信基礎奢施、通訊設備的愾候韌性，	強化公司與供應鏈的碳管理能力，並提升電信基礎設施、通訊設備的氣候韌性，
強化公司與供應憐的碳管理能漓，病提升電釁基褚設施、恫訊設備的氣後韌幸，	強化公司與供應鏈的碳管理能力，並提升電信基礎設施、通訊設備的氣候韌性，
闋保營運不州斷。柬角枋法:提出創心解決枋案，	確保營運不中斷。解決方法:提出創新解決方案，
確保營運不中斷。解決方法:提出創新解決緻案，	確保營運不中斷。解決方法:提出創新解決方案，
確保營運不中端。解決方法:提怵創新解決方菴，	確保營運不中斷。解決方法:提出創新解決方案，
確錶營運不中斷。解攫防髮:提雛創新解決方案，	確保營運不中斷。解決方法:提出創新解決方案，
確保營運不中斷。揀決方法:提出創新解決方案，	確保營運不中斷。解決方法:提出創新解決方案，
減少自身及產業鏈之溫似氣體排放；規劃繼執行「通信網爐因應未來 20 蓮氣候變遷調適型動方案 / 計畫」，	減少自身及產業鏈之溫室氣體排放；規劃及執行「通信網路因應未來 20 年氣候變遷調適行動方案 / 計畫」，
檢少自身及產業鏈之溫室氣體排放；規劃及執惜「通信網路因應未來 20 年氣候變遷調適行動方案 / 計畫」，	減少自身及產業鏈之溫室氣體排放；規劃及執行「通信網路因應未來 20 年氣候變遷調適行動方案 / 計畫」，
減少自身及產業鏈之溫室氣體排放；規劃及執型「軸信網路因應未來 20 年蓿候變遷調適行動方案 / 計畫」，	減少自身及產業鏈之溫室氣體排放；規劃及執行「通信網路因應未來 20 年氣候變遷調適行動方案 / 計畫」，
減少自身及產業鏈之溫室棄體排放；圭劃及執行「通信網路因應未來 20 黏氣候變塹調適行動方案 / 計划」，	減少自身及產業鏈之溫室氣體排放；規劃及執行「通信網路因應未來 20 年氣候變遷調適行動方案 / 計畫」，
減少自身及產業鏈之溫室氣體排放；規劃及執行「臻信網路因應蚱萊 20 年氣候變遷調適邢動方案 / 暨晃」，	減少自身及產業鏈之溫室氣體排放；規劃及執行「通信網路因應未來 20 年氣候變遷調適行動方案 / 計畫」，
展開氣候變遷調適行動。乞候相關財務揭露建議，	展開氣候變遷調適行動。氣候相關財務揭露建議，
展楷氣喉變遷調適行動。氣候鏘關財務揭濾建議，	展開氣候變遷調適行動。氣候相關財務揭露建議，
展楷汽候變遷逃溼熄動。氣候相關裁禦揭露澗議，	展開氣候變遷調適行動。氣候相關財務揭露建議，
展疲氣候變羈調耜行動。細候相關財務揭露建議，	展開氣候變遷調適行動。氣候相關財務揭露建議，
斬開氣候變遷調適興動。氣候相關財務揭露建壹，	展開氣候變遷調適行動。氣候相關財務揭露建議，
我們為全台第鋼家簽署止持 TCFD 倡議的電信掖者，	我們為全台第一家簽署支持 TCFD 倡議的電信業者，
我們為痊台第一家簽署支持 TCFD 悵議的電信業者，	我們為全台第一家簽署支持 TCFD 倡議的電信業者，
我們喂全怡第一家簽署支持 TCFD 倡議的滇信業者，	我們為全台第一家簽署支持 TCFD 倡議的電信業者，
我們偽全台第一家簽署雉池 TCFD 倡員的墊信射者，	我們為全台第一家簽署支持 TCFD 倡議的電信業者，
我們為全台斟一家簽署支持 TCFD 倡議的電信業者，	我們為全台第一家簽署支持 TCFD 倡議的電信業者，
並於 2019 年導肉氣候相關財務揭露（以下簡稱 TCFD），	並於 2019 年導入氣候相關財務揭露（以下簡稱 TCFD），
痺於 2019 年導入棄候庠關綵務縑露（蛾下簡稱 TCFD），	並於 2019 年導入氣候相關財務揭露（以下簡稱 TCFD），
並烏 2019 年導入氣候相關財務結露（以下簡春 TCFD），	並於 2019 年導入氣候相關財務揭露（以下簡稱 TCFD），
並於 2019 年導入氣候俐關財務揭露（以下簡稱 TCFD），	並於 2019 年導入氣候相關財務揭露（以下簡稱 TCFD），
並於 2019 年禱入氣候相倌財務揭鷺（迆下湔稱 TCFD），	並於 2019 年導入氣候相關財務揭露（以下簡稱 TCFD），
展開氣候風險與戟會之分析，據此推動氣厚變遷調適與減緩工作，	展開氣候風險與機會之分析，據此推動氣候變遷調適與減緩工作，
展揩氣候諷險與機會之分析，據此推動氣候卞遷調適與減緩工作，	展開氣候風險與機會之分析，據此推動氣候變遷調適與減緩工作，
展開氣候風險與機會之分析，據此推動氣逅辮仙調適與減緩工作，	展開氣候風險與機會之分析，據此推動氣候變遷調適與減緩工作，
展開氣後風險馭機會之分析，據此推動氣候變遷調適與減緩工作，	展開氣候風險與機會之分析，據此推動氣候變遷調適與減緩工作，
展開訖候風險與機會之分析，據此推動氣候變遷調適與減緩工作，	展開氣候風險與機會之分析，據此推動氣候變遷調適與減緩工作，
