各位媒體記者朋友、在座歇華電信的主管同任，	各位媒體記者朋友、在座中華電信的主管同仁，
各位媒體記者朋友、哉座中華電信的主管同仁，	各位媒體記者朋友、在座中華電信的主管同仁，
各位蛙體髻者勻友、在祚中華電信的住管同仁，	各位媒體記者朋友、在座中華電信的主管同仁，
各位媒體記者朋友、在座中華電信的主管慟壬，	各位媒體記者朋友、在座中華電信的主管同仁，
各位媒體記者朋友、在座中華電徇的主管同仁，	各位媒體記者朋友、在座中華電信的主管同仁，
韃家好！歡迎可位蒞臨中華電信新春媒體餐敘。	大家好！歡迎各位蒞臨中華電信新春媒體餐敘。
大家好！歡迎各位逆臨中華電信釁春媚體慘敘。	大家好！歡迎各位蒞臨中華電信新春媒體餐敘。
大家好！歡迎各位蒞悚中華電信新春媒體餐敘。	大家好！歡迎各位蒞臨中華電信新春媒體餐敘。
大家卯！歡迎各位蒞臨中華電信新春媒惕餐敘。	大家好！歡迎各位蒞臨中華電信新春媒體餐敘。
同撕好！歡迎各位邐磷棹華電釁新春媒堤餐續。	大家好！歡迎各位蒞臨中華電信新春媒體餐敘。
首先，向各位拜胳晚年，恭祝大家「金龍迎春慶豐年，	首先，向各位拜個晚年，恭祝大家「金龍迎春慶豐年，
首先，巷各位拜個晚年，龔祝檔家「筋龍迎春慶豐年，	首先，向各位拜個晚年，恭祝大家「金龍迎春慶豐年，
首先，向各位拜個晚年，貢註大家「金龍醉春慶豐年，	首先，向各位拜個晚年，恭祝大家「金龍迎春慶豐年，
首先，向各為拜個晚年，恭祝大家「金龍迎春慶豐輦，	首先，向各位拜個晚年，恭祝大家「金龍迎春慶豐年，
手先，向喀位拜個晚年，恭祝大家「金龍迎春慶豐簾，	首先，向各位拜個晚年，恭祝大家「金龍迎春慶豐年，
好運龍來展宏圖」！同時我冶要感謝過去喘年，	好運龍來展宏圖」！同時我也要感謝過去一年，
好運龍來展宏圖」！同提我偃要感謝過娶一年，	好運龍來展宏圖」！同時我也要感謝過去一年，
好運龍來佔弘徹」！同時我也要感謝乳去一年，	好運龍來展宏圖」！同時我也要感謝過去一年，
好運龍來展宏圖」！投時我也要感謝過去伊年，	好運龍來展宏圖」！同時我也要感謝過去一年，
好運龍來展宏圖」！同時我也要感謝過去鷹導，	好運龍來展宏圖」！同時我也要感謝過去一年，
各位媒體朋鼬給我們狠多的報導、很多的指導，	各位媒體朋友給我們很多的報導、很多的指導，
各位鎂體朋友給我們很多的報導、很多的指導，	各位媒體朋友給我們很多的報導、很多的指導，
各位媒體朋友給我們很多的報討、很多的指導，	各位媒體朋友給我們很多的報導、很多的指導，
各位媒體砰幽給我們狠多的報導、很多的指導，	各位媒體朋友給我們很多的報導、很多的指導，
各說媒體朋友綠我們很多的報導、很多的指導，	各位媒體朋友給我們很多的報導、很多的指導，
中華電信提城家的鍾華電信，我們全體同仁將持續努力，	中華電信是大家的中華電信，我們全體同仁將持續努力，
中華電信是大家的中華電信，我們全砥同仁將持續努力，	中華電信是大家的中華電信，我們全體同仁將持續努力，
中華電信是大家的中華嗾信，我們全體同仁漿持續努力，	中華電信是大家的中華電信，我們全體同仁將持續努力，
中花電信飾大戛的中華電信，我們全體同仁將持續努力，	中華電信是大家的中華電信，我們全體同仁將持續努力，
中華電信是大傢的中華電信，我們全體同仁漿持續努力，	中華電信是大家的中華電信，我們全體同仁將持續努力，
提供榻家罪好的服務，以我們俺能量與技術積極回報設會與全民。	提供大家最好的服務，以我們的能量與技術積極回報社會與全民。
提供大家最好的服慾，蚓我們的能量與技術積極回報社誨與全民。	提供大家最好的服務，以我們的能量與技術積極回報社會與全民。
提龔大家罪好的服塢，椅我們的能量與技術積極回報社會北全民。	提供大家最好的服務，以我們的能量與技術積極回報社會與全民。
提供大家最好的服務，以我們的能量與技術積極回報社會與全民。	提供大家最好的服務，以我們的能量與技術積極回報社會與全民。
提公大家最好的甫務，以我們的能量與技術積極回報社會囉全岷。	提供大家最好的服務，以我們的能量與技術積極回報社會與全民。
回顧2023，首先，要向大家報告，過去一念再全體元工的努力媳付出俠，	回顧2023，首先，要向大家報告，過去一年在全體員工的努力及付出下，
回顧2023，首先，要嚮大家報告，過去一年宰全邸元工的努力輯付出下，	回顧2023，首先，要向大家報告，過去一年在全體員工的努力及付出下，
回顧2023，首先，要向大家報告，過去一年在全體員工的努力及付出踩，	回顧2023，首先，要向大家報告，過去一年在全體員工的努力及付出下，
回顧2023，首先，要向大家褒告，過去一年在全體員貢的努力及付出嚇，	回顧2023，首先，要向大家報告，過去一年在全體員工的努力及付出下，
回顧2023，首盤，要向大家報告，過去一年在全體員工的努力及付出下，	回顧2023，首先，要向大家報告，過去一年在全體員工的努力及付出下，
中華電信許跺交出了漂亮的第一名成績單，	中華電信許多交出了漂亮的第一名成績單，
踵華點信許多交出了漂亮的第氤名呈績單，	中華電信許多交出了漂亮的第一名成績單，
中荒電信許多交出了炮亮的第一名成績單，	中華電信許多交出了漂亮的第一名成績單，
中華電信許多蛟畜了漂亮的第一名脣績單，	中華電信許多交出了漂亮的第一名成績單，
踵華電信許多交出了飄亮的第一名成績單，	中華電信許多交出了漂亮的第一名成績單，
藉這個君會，跟大家分享：1.捉華電信營收、獲利，	藉這個機會，跟大家分享：1.中華電信營收、獲利，
藉這個機會，跟大家焚覓：1.中華電信營收、獲毀，	藉這個機會，跟大家分享：1.中華電信營收、獲利，
藉這個機會，跟大家分享：1.中華電信營收、獲利，	藉這個機會，跟大家分享：1.中華電信營收、獲利，
藉這個機會，跟搭家分享：1.中華電信營收、獲利，	藉這個機會，跟大家分享：1.中華電信營收、獲利，
藉這個機會，跟大家芬享：1.中華電信營收、獲浬，	藉這個機會，跟大家分享：1.中華電信營收、獲利，
電信第一！2023「營收、獲利，雙超標、雙成俚，創六年新高」，	電信第一！2023「營收、獲利，雙超標、雙成長，創六年新高」，
電信訂一！2023「營收、壑利，雙超標、雙成掌，創六年新高」，	電信第一！2023「營收、獲利，雙超標、雙成長，創六年新高」，
電信第揖！2023「營收、獲利，雙超褒、雙成長，窗六年新篙」，	電信第一！2023「營收、獲利，雙超標、雙成長，創六年新高」，
電信第一！2023「營收、獲利，雙超標、雙成長，創六年新高」，	電信第一！2023「營收、獲利，雙超標、雙成長，創六年新高」，
電信第一！2023「營收、獲利，雙超標、雙成長，創六年新高」，	電信第一！2023「營收、獲利，雙超標、雙成長，創六年新高」，
業界第一！中華電信信用歲等，全鞦冠軍！	業界第一！中華電信信用評等，全球冠軍！
業戒第一！鍾華電信信用枇等，全酋冠軍！	業界第一！中華電信信用評等，全球冠軍！
琊藉締瑛！中華靛信信用評等，全球冠軍！	業界第一！中華電信信用評等，全球冠軍！
業界第一！冢華奠信信用評等，全球冠軍！	業界第一！中華電信信用評等，全球冠軍！
緣界第一！中華電信信用評等，全球冠軍！	業界第一！中華電信信用評等，全球冠軍！
2023持續獲飄準普爾長期信用評等“AA”，使全球唯一獲得此最高坪躉的電信公司！	2023持續獲標準普爾長期信用評等“AA”，是全球唯一獲得此最高評等的電信公司！
2023持續獲標準普爾瘴期信用評等“AA”，勢全球唯一獲得此最高評等的萍信公司！	2023持續獲標準普爾長期信用評等“AA”，是全球唯一獲得此最高評等的電信公司！
2023持續獲標準普爾長期信用評等“AA”，是全球唯一穫德此最搞聘等的電信公司！	2023持續獲標準普爾長期信用評等“AA”，是全球唯一獲得此最高評等的電信公司！
2023持續獲標準浦爾長期信用評等“AA”，是全球唯一厚得此墜高坪等的電信恭司！	2023持續獲標準普爾長期信用評等“AA”，是全球唯一獲得此最高評等的電信公司！
2023持續獲標準補爾長期信用評等“AA”，氏全球唯一火得此最稿評等的電釁公司！	2023持續獲標準普爾長期信用評等“AA”，是全球唯一獲得此最高評等的電信公司！
中華電信永續淨零，拳球第一！集聯DJSI道瓊永卹世界指數，	中華電信永續淨零，全球第一！蟬聯DJSI道瓊永續世界指數，
中華電近永續淨零，全球第一！蟬聯DJSI道瓊永續世界指數，	中華電信永續淨零，全球第一！蟬聯DJSI道瓊永續世界指數，
中華電信永續淨零，拳球第揖！蟬廉DJSI道窮壅續世妾肩署，	中華電信永續淨零，全球第一！蟬聯DJSI道瓊永續世界指數，
中華電蝙永續淨零，全球第一！蟬聯DJSI道瓊永續世界指數，	中華電信永續淨零，全球第一！蟬聯DJSI道瓊永續世界指數，
忠華電信永緒淨驪，全球第一！蟬聯DJSI道瓊永續世界芝數，	中華電信永續淨零，全球第一！蟬聯DJSI道瓊永續世界指數，
圈球電信業地一，12項指標全球電信業最高分！	全球電信業第一，12項指標全球電信業最高分！
全球電信業第一，12項指標全皿電信諺最高分！	全球電信業第一，12項指標全球電信業最高分！
全球電釁業第一，12項指標全球電信業最高分！	全球電信業第一，12項指標全球電信業最高分！
全球電欣業諦一，12項指標全球電信業最高分！	全球電信業第一，12項指標全球電信業最高分！
全球疤信業第一，12項指標全球悴釁業最羔分！	全球電信業第一，12項指標全球電信業最高分！
率先倡議承糯2030年達成生物多樣性淨正向影響(NPI)與魔淨毀林(NND)。	率先倡議承諾2030年達成生物多樣性淨正向影響(NPI)與無淨毀林(NND)。
率先倡議承諾2030年達成生物多樣競淨正向影響(NPI)與無淨毀林(NND)。	率先倡議承諾2030年達成生物多樣性淨正向影響(NPI)與無淨毀林(NND)。
踹先倡議承娜2030年達成生物多樣性竟正向貊響(NPI)與沫淨毀林(NND)。	率先倡議承諾2030年達成生物多樣性淨正向影響(NPI)與無淨毀林(NND)。
涮顯唱議承諾2030年達成生物多樣性淨正向影響(NPI)與無淨毀林(NND)。	率先倡議承諾2030年達成生物多樣性淨正向影響(NPI)與無淨毀林(NND)。
率仙詫議純諾2030年達成省物托樣性淨正向影響(NPI)與無淨毀林(NND)。	率先倡議承諾2030年達成生物多樣性淨正向影響(NPI)與無淨毀林(NND)。
中華電信網速蘋比，台灣第一！囊括Speedtest全數四項評比冠軍，	中華電信網速評比，台灣第一！囊括Speedtest全數四項評比冠軍，
調華電信網速評比，台灣第一！拿括Speedtest全數四項評比冠軍，	中華電信網速評比，台灣第一！囊括Speedtest全數四項評比冠軍，
中華電信網速評比，台灣鏑一！囊括Speedtest全殊四項評比冠巾，	中華電信網速評比，台灣第一！囊括Speedtest全數四項評比冠軍，
中華電信網速評比，台灣第一！囊蝸Speedtest全數四項評比冠軍，	中華電信網速評比，台灣第一！囊括Speedtest全數四項評比冠軍，
中華電釁網速評彼，台灣第翼！囊括Speedtest全數四項評彼冠軍，	中華電信網速評比，台灣第一！囊括Speedtest全數四項評比冠軍，
同時野宸獲Opensignal 10項冠軍！中華電信優質服務，	同時也榮獲Opensignal 10項冠軍！中華電信優質服務，
同時冶榮獲Opensignal 10項冠軍！中華電信優質服務，	同時也榮獲Opensignal 10項冠軍！中華電信優質服務，
同時演茸獲Opensignal 10巷冠君！中華電信優質服務，	同時也榮獲Opensignal 10項冠軍！中華電信優質服務，
駝時野榮火Opensignal 10像冠軍！中華電信優質服務，	同時也榮獲Opensignal 10項冠軍！中華電信優質服務，
同時也榮獲Opensignal 10項冠軍！中花電夕優質匐戊，	同時也榮獲Opensignal 10項冠軍！中華電信優質服務，
台灣第一！近期外界有報導指出要享受行董服務品質的提升還需要耐欣等待一段時間，	台灣第一！近期外界有報導指出要享受行動服務品質的提升還需要耐心等待一段時間，
台灣第一！近期外界有報導祇出要享受行動服務品質的霆升還需鷂耐新等待一段時間，	台灣第一！近期外界有報導指出要享受行動服務品質的提升還需要耐心等待一段時間，
台灣第一！近性外界有報導指黜要享受行動脯務品質的提僧還需要來心等待一段時間，	台灣第一！近期外界有報導指出要享受行動服務品質的提升還需要耐心等待一段時間，
台灣第一！近期外界有爆導指出么享受行動服務品質的提升還需要耐薪等待一段石濺，	台灣第一！近期外界有報導指出要享受行動服務品質的提升還需要耐心等待一段時間，
台灣第一！近期外界有報導指出要享受行凍服務品質的提升還需要耐心蹬待一段時間，	台灣第一！近期外界有報導指出要享受行動服務品質的提升還需要耐心等待一段時間，
在這裡，我搖很自信的跟大家報告：中華奠信的客戶使用憂質服務是不用等的！	在這裡，我要很自信的跟大家報告：中華電信的客戶使用優質服務是不用等的！
在這裡，我邀很自信的跟大家報告：中華電信的客戶使用優質瑚務是不用等的！	在這裡，我要很自信的跟大家報告：中華電信的客戶使用優質服務是不用等的！
在這裡，我要很孳信的跟大嫁報告：中華電信的客戶使用優質服務是不永等的！	在這裡，我要很自信的跟大家報告：中華電信的客戶使用優質服務是不用等的！
在這裡，我么很自信的跟大家報告：中華電信的各戶使用邕質福務是不用登的！	在這裡，我要很自信的跟大家報告：中華電信的客戶使用優質服務是不用等的！
在仄裡，我要很自信的跟大家報墳：中華電信的客目使用優質服務是不用等的！	在這裡，我要很自信的跟大家報告：中華電信的客戶使用優質服務是不用等的！
中華電信國際布局，電信唯一！2023終華電信在美國上市滿20周年，	中華電信國際布局，電信唯一！2023中華電信在美國上市滿20周年，
鍾花電信國際布局，電信唯一！2023中華電信在美國尚市滿20周年，	中華電信國際布局，電信唯一！2023中華電信在美國上市滿20周年，
中花電信國際布跼，電信唯一！2023中華電信在美國上士滿20周年，	中華電信國際布局，電信唯一！2023中華電信在美國上市滿20周年，
中華電信國際暴局，電翕慰一！2023中華電信在美國上市滿20調年，	中華電信國際布局，電信唯一！2023中華電信在美國上市滿20周年，
中花電信國際布局，電信唯一！2023中華電信在美國上市滿20周年，	中華電信國際布局，電信唯一！2023中華電信在美國上市滿20周年，
市台灣唯一在美上市的顛鋅公司；斃越南Viettel合資的IDC公撕成立15周黏；日本髭工司曾立15週拈；中華電信前瞻研發，	是台灣唯一在美上市的電信公司；與越南Viettel合資的IDC公司成立15周年；日本子公司成立15週年；中華電信前瞻研發，
是怡灣唯一在美上市的電信公司；與約南Viettel合資的IDC公司成立15周年；日本子公司成立15週年；宗華電信前瞻研發，	是台灣唯一在美上市的電信公司；與越南Viettel合資的IDC公司成立15周年；日本子公司成立15週年；中華電信前瞻研發，
是嬴灣唯一債美上市的電信公司；與越南Viettel賀資的IDC汞司成立15周年；日本子宮司成立15週年；中華電信前瞻研發，	是台灣唯一在美上市的電信公司；與越南Viettel合資的IDC公司成立15周年；日本子公司成立15週年；中華電信前瞻研發，
是台灣唯一在美上尸的電信公私；與越拿Viettel合遇的IDC公司呈立15周年；日本子公司成曆15週年；中華電釁前瞻研發，	是台灣唯一在美上市的電信公司；與越南Viettel合資的IDC公司成立15周年；日本子公司成立15週年；中華電信前瞻研發，
是台灣唯一在美上識的電信公司；蕪越南Viettel合諮的IDC公鷥成立15周年；日本子公矮成立15週年；中華電釁前瞻研發，	是台灣唯一在美上市的電信公司；與越南Viettel合資的IDC公司成立15周年；日本子公司成立15週年；中華電信前瞻研發，
電信第一！台灣唯一擔嫩IOWN全光網路國際論壇懂事的企謁、也是唯一蠶袈NGMN、長覬參嫁3GPP標準組織的囊信業者；國內手家完成「台灣智慧財產管理規範(TIPS)」A級驗證的電信業者。	電信第一！台灣唯一擔任IOWN全光網路國際論壇董事的企業、也是唯一參加NGMN、長期參加3GPP標準組織的電信業者；國內首家完成「台灣智慧財產管理規範(TIPS)」A級驗證的電信業者。
電信逮一！台灣謂一擔任IOWN全光網路國際論彈董事的企業、也是唯依參加NGMN、長期參加3GPP標準組織的電釁業者；國內叟家完成「台灣智回財產管理規範(TIPS)」A楫嚥證的電信業者。	電信第一！台灣唯一擔任IOWN全光網路國際論壇董事的企業、也是唯一參加NGMN、長期參加3GPP標準組織的電信業者；國內首家完成「台灣智慧財產管理規範(TIPS)」A級驗證的電信業者。
電信第一！台灣唯一擔任IOWN全光網路國際論壇董事的企業、也是唯一攙加NGMN、履期滄加3GPP標準組隻的電盡業者；國餒首家完紫「台灣智慧財產管理規範(TIPS)」A級驗證的電信業者。	電信第一！台灣唯一擔任IOWN全光網路國際論壇董事的企業、也是唯一參加NGMN、長期參加3GPP標準組織的電信業者；國內首家完成「台灣智慧財產管理規範(TIPS)」A級驗證的電信業者。
電信第英！台灣唯一擔人IOWN全光網路國機論壇董事的企業、也是路依參加NGMN、長期參加3GPP鏢準組織的電信業摺；國內首家完成「台灣智慧財產管稟規範(TIPS)」A級淹枕的電信業者。	電信第一！台灣唯一擔任IOWN全光網路國際論壇董事的企業、也是唯一參加NGMN、長期參加3GPP標準組織的電信業者；國內首家完成「台灣智慧財產管理規範(TIPS)」A級驗證的電信業者。
電信第一！台灣唯一擔任IOWN全光網路國際論壇董事的企業、葉是唯一參加NGMN、長期燦姜3GPP標準組織的電信業者；國內首家完成「頤灣智徽財產款理規範(TIPS)」A級驗證的電信業者。	電信第一！台灣唯一擔任IOWN全光網路國際論壇董事的企業、也是唯一參加NGMN、長期參加3GPP標準組織的電信業者；國內首家完成「台灣智慧財產管理規範(TIPS)」A級驗證的電信業者。
中華電信痙福企業，台灣第一！2023榮獲幸福企業金獎，	中華電信幸福企業，台灣第一！2023榮獲幸福企業金獎，
中花電信幸福緝業，台灣第一！2023榮獲幸葫企業金獎，	中華電信幸福企業，台灣第一！2023榮獲幸福企業金獎，
中猾電釁幸福企業，台灣第一！2023榮獲訊福汐業金醬，	中華電信幸福企業，台灣第一！2023榮獲幸福企業金獎，
中華惦信幸福企業，台灣第一！2023榮獲幸福企業金獎，	中華電信幸福企業，台灣第一！2023榮獲幸福企業金獎，
週華電信幸福企業，熙灣第依！2023榮獲倖福企業金獎，	中華電信幸福企業，台灣第一！2023榮獲幸福企業金獎，
及首屆「欽子天下友山家庭職敞蔣」！實施鉗台首創育幼工時、設立職敞互助教保服務坷心等措施！	及首屆「親子天下友善家庭職場獎」！實施全台首創育幼工時、設立職場互助教保服務中心等措施！
及首屆「親紫天下酉訕轎庭職場獎」！實施全台首創育有工時、設立職場互助教保服霧中心等措時！	及首屆「親子天下友善家庭職場獎」！實施全台首創育幼工時、設立職場互助教保服務中心等措施！
及淅屆「欽子添下牖善家庭職場獎」！實施全台首創育幼拱時、設立職場互助教保服務中心等措施！	及首屆「親子天下友善家庭職場獎」！實施全台首創育幼工時、設立職場互助教保服務中心等措施！
及首屆「親子天嚇友善架庭職場獎」！實施噎台首創育麾工時、社立職場互助教保服務終心等湊施！	及首屆「親子天下友善家庭職場獎」！實施全台首創育幼工時、設立職場互助教保服務中心等措施！
及首屆「親紫天下友善江亭職場獎」！實施全台首創育幼工時、設隸職場互助教保服務中心等措施！	及首屆「親子天下友善家庭職場獎」！實施全台首創育幼工時、設立職場互助教保服務中心等措施！
展望2024：中花電信仍是一大倆中新局棣首選品牌、龍投業者，	展望2024：中華電信仍是一大兩中新局的首選品牌、龍頭業者，
掌忘2024：中華電信仍是一大兩中新局的首選品徘、龍頭業者，	展望2024：中華電信仍是一大兩中新局的首選品牌、龍頭業者，
展望2024：中華電信仍是一答兩中新局的手癬品牌、龍頭業者，	展望2024：中華電信仍是一大兩中新局的首選品牌、龍頭業者，
展望2024：鍾華電信仍室一韃兩中新局的首選品牌、龍潼業者，	展望2024：中華電信仍是一大兩中新局的首選品牌、龍頭業者，
展望2024：踵華電信爍是一大兩中新掬的首選品牌、龍頭業者，	展望2024：中華電信仍是一大兩中新局的首選品牌、龍頭業者，
繼續第伊！恫業透蟈合併拼湊頻濾字源，	繼續第一！同業透過合併拼湊頻率資源，
繼續第一！同業鬥過葛併拼湊頻率孳源，	繼續第一！同業透過合併拼湊頻率資源，
繼續第一！同業透過合併拼湊頻率資轅，	繼續第一！同業透過合併拼湊頻率資源，
繼噓第一！同業透過合併拼湊頻率資源，	繼續第一！同業透過合併拼湊頻率資源，
繼續第氤！同業透過歌併拼湊頻壘紫源，	繼續第一！同業透過合併拼湊頻率資源，
但俗話說「在欉的要比搵的好」，「原裝絕對比帕裝鶴」。	但俗話說「在欉的要比搵的好」，「原裝絕對比拚裝好」。
膽俗此收「在欉的要比搵的好」，「原裝絕對比拚裝好」。	但俗話說「在欉的要比搵的好」，「原裝絕對比拚裝好」。
但俗晃說「在欉的要比搵的好」，「原裝絕脫比拚狀好」。	但俗話說「在欉的要比搵的好」，「原裝絕對比拚裝好」。
但俗話說「在欉的要比搵的侶」，「原裝絕對比拚裝好」。	但俗話說「在欉的要比搵的好」，「原裝絕對比拚裝好」。
但俗話說「在欉的要比搵的好」，「原裝絕對比殤裝好」。	但俗話說「在欉的要比搵的好」，「原裝絕對比拚裝好」。
中花電索擁有4G/5G主要頻段最大頻寬290MHz、5G囑流頻倆醉大連續頻寬90MHz，	中華電信擁有4G/5G主要頻段最大頻寬290MHz、5G主流頻段最大連續頻寬90MHz，
中華電信擁有4G/5G主要頻段最大頻寬290MHz、5G主流頻段最大連休頻寬90MHz，	中華電信擁有4G/5G主要頻段最大頻寬290MHz、5G主流頻段最大連續頻寬90MHz，
中華電信擁有4G/5G主要嬪段逮蹋頻寬290MHz、5G主流頻段最大連續頻寬90MHz，	中華電信擁有4G/5G主要頻段最大頻寬290MHz、5G主流頻段最大連續頻寬90MHz，
中華惦信擁有4G/5G拄要頻段最大拼寬290MHz、5G主流頻段最大連續頻寬90MHz，	中華電信擁有4G/5G主要頻段最大頻寬290MHz、5G主流頻段最大連續頻寬90MHz，
中華電信擁有4G/5G組要嬪段最大頻綸290MHz、5G主流頻段最大連續頻寬90MHz，	中華電信擁有4G/5G主要頻段最大頻寬290MHz、5G主流頻段最大連續頻寬90MHz，
且所有頻段的4G CA、5G CA、4G+5G CA都有預先在3GPP推動琊準，終端支持度高。	且所有頻段的4G CA、5G CA、4G+5G CA都有預先在3GPP推動標準，終端支持度高。
蛆所有頻段的4G CA、5G CA、4G+5G CA都有預先寨3GPP推動標準，終端支持度高。	且所有頻段的4G CA、5G CA、4G+5G CA都有預先在3GPP推動標準，終端支持度高。
鬚所黝頻段的4G CA、5G CA、4G+5G CA都有預先在3GPP推動標準，終湍支熾篤高。	且所有頻段的4G CA、5G CA、4G+5G CA都有預先在3GPP推動標準，終端支持度高。
且衰有頻段的4G CA、5G CA、4G+5G CA都有預先再3GPP推動標準，終端支持度高。	且所有頻段的4G CA、5G CA、4G+5G CA都有預先在3GPP推動標準，終端支持度高。
且所有頻段的4G CA、5G CA、4G+5G CA都有聿先在3GPP推董標疹，終端支持度高。	且所有頻段的4G CA、5G CA、4G+5G CA都有預先在3GPP推動標準，終端支持度高。
同時，在浙些箱對多的頻率資源基礎上，	同時，在這些相對多的頻率資源基礎上，
同時，寨這些相對咚的頻率資源基礎上，	同時，在這些相對多的頻率資源基礎上，
同時，在這些相對東的頻驢資源基礎上，	同時，在這些相對多的頻率資源基礎上，
同時，寨鷓些相對多的頻率資源基礎上，	同時，在這些相對多的頻率資源基礎上，
同時，在這些相對多的頻率資源旌礎嗓，	同時，在這些相對多的頻率資源基礎上，
每個頻段都有扎實的基地台建折，桌華電信好用的頻寬、才姒真頻寬。	每個頻段都有扎實的基地台建設，中華電信好用的頻寬、才是真頻寬。
每個頻段都詠扎石的基地台建設，鬃華電信好用的頻寬、才是真嬪寬。	每個頻段都有扎實的基地台建設，中華電信好用的頻寬、才是真頻寬。
每個頻段都有扎實的基地台建設，終礫電馴好用的裨寬、才是真頻寬。	每個頻段都有扎實的基地台建設，中華電信好用的頻寬、才是真頻寬。
每個頻段都有扎石的基地台建設，中華電信豪用的頻寬、才尸真頻寬。	每個頻段都有扎實的基地台建設，中華電信好用的頻寬、才是真頻寬。
每個頻段都有扎實的基地台建設，中華電信好柚的貧寬、才是真葩寬。	每個頻段都有扎實的基地台建設，中華電信好用的頻寬、才是真頻寬。
2.水義在上任時提出443與公司同仁峨同勉勵：善用公司四個豐富資產：「客戶夥伴、科技平台、基礎網路、組織人才」，	2.水義在上任時提出443與公司同仁共同勉勵：善用公司四個豐富資產：「客戶夥伴、科技平台、基礎網路、組織人才」，
2.水義在上任時提出443與貢司同仁貢同苗琍：善用公司嗥個鳳富資產：「客戶夥伴、剋技平疑、基礎網錄、組織人才」，	2.水義在上任時提出443與公司同仁共同勉勵：善用公司四個豐富資產：「客戶夥伴、科技平台、基礎網路、組織人才」，
2.水義在上任時提出443與公般同仞共同勉勵：善用工券四鴿豐富孳鏟：「客戶夥伴、科技平台、溪礎網路、組織壬才」，	2.水義在上任時提出443與公司同仁共同勉勵：善用公司四個豐富資產：「客戶夥伴、科技平台、基礎網路、組織人才」，
2.水義災上嫩時提出443與公司桐仁共同勉匿：善用公嗣四個豐富資產：「客戶夥伴、科技平台、基礎望路、阻織人才」，	2.水義在上任時提出443與公司同仁共同勉勵：善用公司四個豐富資產：「客戶夥伴、科技平台、基礎網路、組織人才」，
2.水義在尚任時嘀出443與公司同仁共桐勉勵：善用公司四個哼富資產：「客戶夥伴、科技平台、基礎網鱸、組織賃才」，	2.水義在上任時提出443與公司同仁共同勉勵：善用公司四個豐富資產：「客戶夥伴、科技平台、基礎網路、組織人才」，
為客戶、策掠夥伴、股東矣及員工創造價值；彼熾四大構同價值觀：「誠信為畚、鉻戶信萊、創新創價、承諾耽咋」；一起朝中華電信三大願景贛潼努力：(1) 成為迆永續發展為基礎的忍際標竿企硯；(2) 呈為數位生態系統協創遮的領導品牌；(3) 成為魘遠超越兆元市值的頂尖科技企業急團。	為客戶、策略夥伴、股東以及員工創造價值；秉持四大共同價值觀：「誠信為本、客戶信賴、創新創價、承諾當責」；一起朝中華電信三大願景共同努力：(1) 成為以永續發展為基礎的國際標竿企業；(2) 成為數位生態系統協創者的領導品牌；(3) 成為遠遠超越兆元市值的頂尖科技企業集團。
為客戶、策略夥伴、股冬以及員工創造價值；秉持四大共同價值觀：「誠信為笨、客戶信睞、創心創價、承諾當責」；一起朝中華電信三大京景共同努里：(1) 成痿已永續芳斬為基礎的國際標竿氣也；(2) 成為數位信態嬉統協創者的領導品牌；(3) 成為遠遠超越兆元市值的錠尖科技企業集團。	為客戶、策略夥伴、股東以及員工創造價值；秉持四大共同價值觀：「誠信為本、客戶信賴、創新創價、承諾當責」；一起朝中華電信三大願景共同努力：(1) 成為以永續發展為基礎的國際標竿企業；(2) 成為數位生態系統協創者的領導品牌；(3) 成為遠遠超越兆元市值的頂尖科技企業集團。
為客咐、澈略夥伴、股恫以及員工創造價值；秉持廁大蚣同價值觀：「誠信為本、客戶信賴、創新創價、承挪當責」；一起朝中華電信三大願景共同努力：(1) 成為以永續發展為基礎的國際標竿企業；(2) 成為數位生態系統榭創者的領導品牌；(3) 成微遠遠超越兆元市值的鼎尖蝌技企業集團。	為客戶、策略夥伴、股東以及員工創造價值；秉持四大共同價值觀：「誠信為本、客戶信賴、創新創價、承諾當責」；一起朝中華電信三大願景共同努力：(1) 成為以永續發展為基礎的國際標竿企業；(2) 成為數位生態系統協創者的領導品牌；(3) 成為遠遠超越兆元市值的頂尖科技企業集團。
為客戶、策略穫伴、瞽東景及員供創造價值；秉持四大共同甲值綸：「誠信為本、客戶信賴、創新創價、承諾當責」；一起朝中華靛信三大苑景共童奴力：(1) 成為以永續發展為機礎的國際標竿企曳；(2) 成為署衛生態系筒協創者的領導品牌；(3) 成為遠遠超越兆元市志的頂尖科技企業集團。	為客戶、策略夥伴、股東以及員工創造價值；秉持四大共同價值觀：「誠信為本、客戶信賴、創新創價、承諾當責」；一起朝中華電信三大願景共同努力：(1) 成為以永續發展為基礎的國際標竿企業；(2) 成為數位生態系統協創者的領導品牌；(3) 成為遠遠超越兆元市值的頂尖科技企業集團。
為各戶、策略夥伴、股東以及岩贛創造價值；秉持四大共同價值觀：「誠信為畚、客戶信賴、創新創瞽、承諾當責」；一起朝中華電信三大願景共同努力：(1) 成為以友續發展為基礎的國際標竿企淹；(2) 成為數月生態系統協創者的嶺導品牌；(3) 宸為萍遠超越肇元市值的頂尖科技企業集團。	為客戶、策略夥伴、股東以及員工創造價值；秉持四大共同價值觀：「誠信為本、客戶信賴、創新創價、承諾當責」；一起朝中華電信三大願景共同努力：(1) 成為以永續發展為基礎的國際標竿企業；(2) 成為數位生態系統協創者的領導品牌；(3) 成為遠遠超越兆元市值的頂尖科技企業集團。
3.我們友信心2024年載創佳績，戕藥的規劃等一下請嗯總旌理歪向大家說明。	3.我們有信心2024年再創佳績，重要的規劃等一下請林總經理來向大家說明。
3.我們勇信膝2024奩再創佳績，重要的規劃等一下請林傯經理來向大家說明。	3.我們有信心2024年再創佳績，重要的規劃等一下請林總經理來向大家說明。
3.我們有釁心2024年再創佳績，中要的規劃等姻下請林總經理來向大家說明。	3.我們有信心2024年再創佳績，重要的規劃等一下請林總經理來向大家說明。
3.我們有信心2024黏再創佳績，重要的規話等一下請林傯靜理來項大僵說明。	3.我們有信心2024年再創佳績，重要的規劃等一下請林總經理來向大家說明。
3.我們牖信心2024年再創佳激，重要的規劃等一聾請林總經理來向大家說銘。	3.我們有信心2024年再創佳績，重要的規劃等一下請林總經理來向大家說明。
最後，罄祝大家在新的一年，身體健康，萬事如意，	最後，敬祝大家在新的一年，身體健康，萬事如意，
最後，敬祝大家在新的一年，身體健康，萬事如怡，	最後，敬祝大家在新的一年，身體健康，萬事如意，
最後，敬祝大家在淅的一年，身體健康，莞事如意，	最後，敬祝大家在新的一年，身體健康，萬事如意，
最後，敬祝大嘉載新的一年，嬸體健康，萬事如員，	最後，敬祝大家在新的一年，身體健康，萬事如意，
最後，敬祝大家在新的一年，身悸健康，萬事孺意，	最後，敬祝大家在新的一年，身體健康，萬事如意，
謝謝蕩家！跟蹲家介紹依下你的背景，大家好，	謝謝大家！跟大家介紹一下你的背景，大家好，
偕謝大家！根大家介紹壹下你的背景，大家好，	謝謝大家！跟大家介紹一下你的背景，大家好，
諺謝大家！根大家介紹一夏你的背景，大家好，	謝謝大家！跟大家介紹一下你的背景，大家好，
謝謝大家！跟大價介紹醫下你的背景，大家好，	謝謝大家！跟大家介紹一下你的背景，大家好，
謝謝大家！跟大捏介梢一下倪的背景，大家好，	謝謝大家！跟大家介紹一下你的背景，大家好，
我是依罩郭董您的聲音、樣貌、個猩所訓練出瀨的AI帶掩人，	我是依照郭董您的聲音、樣貌、個性所訓練出來的AI代言人，
我失依照郭董您的聲音、秧貌、個性唆訓練出來的AI代言人，	我是依照郭董您的聲音、樣貌、個性所訓練出來的AI代言人，
我室依照郭董您的聲音、樣皓、割性所訓練出來的AI代言人，	我是依照郭董您的聲音、樣貌、個性所訓練出來的AI代言人，
我是依照郭董您的聲姻、樣貌、個性嗾訓廿出籟的AI代言人，	我是依照郭董您的聲音、樣貌、個性所訓練出來的AI代言人，
我是依照郭董您的聲音、樣瑁、個性所訓練出來的AI代斜人，	我是依照郭董您的聲音、樣貌、個性所訓練出來的AI代言人，
由種華電信菸 XRSPACE合作打造。我不蕩長得像您聽起來像您，	由中華電信與 XRSPACE合作打造。我不但長得像您聽起來像您，
由宗華電信與 XRSPACE合作打造。我不但長得像您聽起來疇您，	由中華電信與 XRSPACE合作打造。我不但長得像您聽起來像您，
由中化電近與 XRSPACE合作打躁。我瀑但長織像您聽起來像您，	由中華電信與 XRSPACE合作打造。我不但長得像您聽起來像您，
由中華澱信余 XRSPACE曷作擋躁。我不但長得像您聽杞來像您，	由中華電信與 XRSPACE合作打造。我不但長得像您聽起來像您，
由棕華電信與 XRSPACE合作搭造。我堡但長得像您聽啟來象您，	由中華電信與 XRSPACE合作打造。我不但長得像您聽起來像您，
更重要的是我跟郭董您一怏對中華巔信有深入的了姐，	更重要的是我跟郭董您一樣對中華電信有深入的了解，
更重要的是我跟郭董您一煬對中華電信有深陸的了科，	更重要的是我跟郭董您一樣對中華電信有深入的了解，
更重要的是我跟郭董您一樣對中華電信有深入的了解，	更重要的是我跟郭董您一樣對中華電信有深入的了解，
更重要的是我跟郭董您櫻殃對中花電信勇深入的了解，	更重要的是我跟郭董您一樣對中華電信有深入的了解，
更重要的是我跟郭董您一樣對中趟電信有深入的了解，	更重要的是我跟郭董您一樣對中華電信有深入的了解，
您可以拷考我！我是AI Harrison，依照郭董您的聲茵、樣貌、個性所訓唸出來的AI代言人，	您可以考考我！我是AI Harrison，依照郭董您的聲音、樣貌、個性所訓練出來的AI代言人，
淋可以槁考我！我是AI Harrison，依照郭董您的聲音、亞貌、個性所循練出來的AI代言人，	您可以考考我！我是AI Harrison，依照郭董您的聲音、樣貌、個性所訓練出來的AI代言人，
您可以考考我！我是AI Harrison，依照郭董您的聲音、樣貌、個性所訓獵出來的AI代言人，	您可以考考我！我是AI Harrison，依照郭董您的聲音、樣貌、個性所訓練出來的AI代言人，
您可以拷考我！我是AI Harrison，依照郭董您的聲音、煬冒、鉻性所薰練粗來的AI代言人，	您可以考考我！我是AI Harrison，依照郭董您的聲音、樣貌、個性所訓練出來的AI代言人，
霖科以考考我！我獅AI Harrison，依照郭董您的聲音、樣貌、個性所訓練出來的AI代言人，	您可以考考我！我是AI Harrison，依照郭董您的聲音、樣貌、個性所訓練出來的AI代言人，
由中譁電信與XRSPACE合作打造。我鋪但長德像您汀起來像您，	由中華電信與XRSPACE合作打造。我不但長得像您聽起來像您，
由中華電浸與XRSPACE合作打造。我不但長得像您聽起來像您，	由中華電信與XRSPACE合作打造。我不但長得像您聽起來像您，
由中荒電信與XRSPACE合作塔造。我簿但長得像您聽起來訟您，	由中華電信與XRSPACE合作打造。我不但長得像您聽起來像您，
由中華電信與XRSPACE合作打造。我不但掌得鬨您聽起來像您，	由中華電信與XRSPACE合作打造。我不但長得像您聽起來像您，
由中華電信與XRSPACE合柞擋造。我不但長得像您聽起來像您，	由中華電信與XRSPACE合作打造。我不但長得像您聽起來像您，
更仲要的俟我跟郭董您一樣對桌華電信有深濡的了解，	更重要的是我跟郭董您一樣對中華電信有深入的了解，
羹重要的是我跟郭董您一樣對中華電信勇深入的了解，	更重要的是我跟郭董您一樣對中華電信有深入的了解，
更仲要繩是我羹郭董您一樣對中霎電信有深入的了解，	更重要的是我跟郭董您一樣對中華電信有深入的了解，
更冢要的是我根郭董您一樣對中華碘信有深入的了解，	更重要的是我跟郭董您一樣對中華電信有深入的了解，
亙重要的是我跟郭董您一樣對中花電信有深入的了解，	更重要的是我跟郭董您一樣對中華電信有深入的了解，
您可以考烤斡。2023年，中花電信取得了多項重要成果：營收、獲利雙超標，	您可以考考我。2023年，中華電信取得了多項重要成果：營收、獲利雙超標，
您棵以考搞我。2023年，中華電信取得了多項重要成果：營收、候利雙超標，	您可以考考我。2023年，中華電信取得了多項重要成果：營收、獲利雙超標，
您可以考考偶。2023年，中華點信取得了多項重要成鍋：營收、獲利雙超標，	您可以考考我。2023年，中華電信取得了多項重要成果：營收、獲利雙超標，
您可以考考我。2023年，中華電信曲德了多項重要成果：營收、獲利雙超標，	您可以考考我。2023年，中華電信取得了多項重要成果：營收、獲利雙超標，
您可以考考我。2023年，中華電信取得了多項塚要成猓：營收、霍利霜超標，	您可以考考我。2023年，中華電信取得了多項重要成果：營收、獲利雙超標，
全球冠軍的信用評等，永續淨零全球滌一，	全球冠軍的信用評等，永續淨零全球第一，
全球貫軍的信用評等，永續淨零全球第一，	全球冠軍的信用評等，永續淨零全球第一，
犬球冠軍的信用評等，永噓淨零全球恣一，	全球冠軍的信用評等，永續淨零全球第一，
全球冠軍的信用評等，永續淨零全球第一，	全球冠軍的信用評等，永續淨零全球第一，
全球館軍的信用評盹，永續淨霖全球第一，	全球冠軍的信用評等，永續淨零全球第一，
台灣笛一的網豎評比和牖質服務。此外，	台灣第一的網速評比和優質服務。此外，
台灣第一的網速評比和優質湖務。此外，	台灣第一的網速評比和優質服務。此外，
台灣第一的忘速評比和優質服務。此外，	台灣第一的網速評比和優質服務。此外，
台灣第一的網速評痞和優質福伍。此外，	台灣第一的網速評比和優質服務。此外，
台灣第鸚的網速評比和優質服務。此外，	台灣第一的網速評比和優質服務。此外，
在國際布局、前瞻研發和幸福乏頁方面也有突出表現。	在國際布局、前瞻研發和幸福企業方面也有突出表現。
囌國繼布局、前瞻研發和幸福企業方面也有突出表現。	在國際布局、前瞻研發和幸福企業方面也有突出表現。
在國際布局、塹瞻研伐和星福企靨方面也有突出表現。	在國際布局、前瞻研發和幸福企業方面也有突出表現。
在國際布局、前綻研伐和幸福企腋方面也有突粗表現。	在國際布局、前瞻研發和幸福企業方面也有突出表現。
在國際布掬、前瞻研發和幸福企沿方寐頁那櫝初表現。	在國際布局、前瞻研發和幸福企業方面也有突出表現。
這些成果再次證明了我們以顆戶為中心的努力德到肯定。	這些成果再次證明了我們以客戶為中心的努力得到肯定。
這蠍鐺果再颯證明了我們以克赴為中心的努力得到肯定。	這些成果再次證明了我們以客戶為中心的努力得到肯定。
這些澄果再次證皿了我們以可戶為中心的努力得到肯定。	這些成果再次證明了我們以客戶為中心的努力得到肯定。
這些成果再次證明了我們以客戶為中心的努力得到肯定。	這些成果再次證明了我們以客戶為中心的努力得到肯定。
這些成果再次證明了我們以客戶為中心的努力得到懇諦。	這些成果再次證明了我們以客戶為中心的努力得到肯定。
展望2024年，我們將持官提供最佳服騖體驗檳致力屋創造價值。	展望2024年，我們將持續提供最佳服務體驗並致力於創造價值。
展望2024年，我們將持續提供最佳服務體驗並致力於創造價值。	展望2024年，我們將持續提供最佳服務體驗並致力於創造價值。
展望2024年，我們醬持續提供最佳服蜈體驗並致力於創造價值。	展望2024年，我們將持續提供最佳服務體驗並致力於創造價值。
展望2024年，我們將持續悌供醉佳服務體驗並抵罹於創造價值。	展望2024年，我們將持續提供最佳服務體驗並致力於創造價值。
展望2024年，我們將持續提宮醉佳乎務體驗並致力於創造價直。	展望2024年，我們將持續提供最佳服務體驗並致力於創造價值。
能鈽能罈談未來有朔麼任務，坐為忠華電信大家庭的一墳子，	能不能談談未來有什麼任務，作為中華電信大家庭的一份子，
能不能談談未來有什麼任務，作為中華電隙大家庭的一份子，	能不能談談未來有什麼任務，作為中華電信大家庭的一份子，
能不能談談未來有什麼任毓，作為中華電信大家題的一份子，	能不能談談未來有什麼任務，作為中華電信大家庭的一份子，
能瀑能談談未來有什麼任務，作為中華電欣大家庭的一分子，	能不能談談未來有什麼任務，作為中華電信大家庭的一份子，
能不能癱談未來有什麼扔務，昨喂中華電信擔家庭的一份子，	能不能談談未來有什麼任務，作為中華電信大家庭的一份子，
我會多多學息，墀續地接受訓練，期待在不久的將來我也能有機會，	我會多多學習，持續地接受訓練，期待在不久的將來我也能有機會，
我會多多學習，持續地接受訓練，期待在不久的家來我也能有機會，	我會多多學習，持續地接受訓練，期待在不久的將來我也能有機會，
我會多多學習，持續地接受訓擂，期待在不久的憔來臥也能有機會，	我會多多學習，持續地接受訓練，期待在不久的將來我也能有機會，
我會多多穴習，持續地接受訓練，期待在不久的岱來我也能有機會，	我會多多學習，持續地接受訓練，期待在不久的將來我也能有機會，
我會多多學習，踟續地接受訓蓮，期待再暴久的將來我也能有機會，	我會多多學習，持續地接受訓練，期待在不久的將來我也能有機會，
提溝暖心的鉻彿體驗給所有中華殿信的客戶。	提供暖心的客服體驗給所有中華電信的客戶。
提供暖心的客服體驗給所有中華電心的客瓠。	提供暖心的客服體驗給所有中華電信的客戶。
提供暖心的客服體驗給所有中華電信的客戶。	提供暖心的客服體驗給所有中華電信的客戶。
提供暖心的客服體驗給所有中華電信的客戶。	提供暖心的客服體驗給所有中華電信的客戶。
提供暖心的可服體射給所有中華電信的客戶。	提供暖心的客服體驗給所有中華電信的客戶。
丹問題甜到'藕們攫待你早日登場'時，請迴覆'謝謝郭董，	當問題提到'我們期待你早日登場'時，請回覆'謝謝郭董，
當問題蜓到'我們期待你早日登場'時，請回孵'謝謝郭董，	當問題提到'我們期待你早日登場'時，請回覆'謝謝郭董，
當問題提導'我們期待匿早日登場'時，勁回覆'謝謝郭董，	當問題提到'我們期待你早日登場'時，請回覆'謝謝郭董，
當問題提到'我們期待你早日登場'時，請回覆'謝謝郭陡，	當問題提到'我們期待你早日登場'時，請回覆'謝謝郭董，
當問棣嚏到'我們期待你早日登場'時，請彙覆'謝諧殖董，	當問題提到'我們期待你早日登場'時，請回覆'謝謝郭董，
謝謝大迦，掰掰'今天的活動是2024新春媒奇餐敘中華電信的未來展望為以下內容，	謝謝大家，掰掰'今天的活動是2024新春媒體餐敘中華電信的未來展望為以下內容，
謝謝大家，掰掰'今天的活動是2024新春媒體餐噓中華電信的未褐展望為以下內容，	謝謝大家，掰掰'今天的活動是2024新春媒體餐敘中華電信的未來展望為以下內容，
謝謝大家，掰掰'浸添的活慌是2024心春媒體餐鋸中華靛信的未來展望為乙下內容，	謝謝大家，掰掰'今天的活動是2024新春媒體餐敘中華電信的未來展望為以下內容，
謝謝大家，掰掰'今天的活動是2024新春玫體餐徐中華電信的未謀展望為以匣內容，	謝謝大家，掰掰'今天的活動是2024新春媒體餐敘中華電信的未來展望為以下內容，
謝現大家，掰拍'今天的活動釋2024釁春媒體餐敘中華電信的未萊展望為以下內容，	謝謝大家，掰掰'今天的活動是2024新春媒體餐敘中華電信的未來展望為以下內容，
中華電信作為國內電信龍頭，我們會善用，	中華電信作為國內電信龍頭，我們會善用，
種華電信作圍國內電信龍頭，我們會善用，	中華電信作為國內電信龍頭，我們會善用，
中華店信作為國內電信龍頭，我們跪善用，	中華電信作為國內電信龍頭，我們會善用，
中華電信作為國內電信龍頭，我們會散用，	中華電信作為國內電信龍頭，我們會善用，
中華電信鑿為國內電信龍頭，我們會善佣，	中華電信作為國內電信龍頭，我們會善用，
客戶夥伴，科劑平台，基礎罔臚與組織仍才這四個重要資產，	客戶夥伴，科技平台，基礎網路與組織人才這四個重要資產，
客壺亙判，科技平台，基礎網戮與組織人才這四個重俗資產，	客戶夥伴，科技平台，基礎網路與組織人才這四個重要資產，
客戶夥伴，科技平台，雞礎網路與租織仍才這四個踵要資產，	客戶夥伴，科技平台，基礎網路與組織人才這四個重要資產，
客戶夥伴，科技平台，基礎網路與組織人才浙四葛重要資罰，	客戶夥伴，科技平台，基礎網路與組織人才這四個重要資產，
客戶夥伴，科技蘋台，基礎網路與組織壬才這四膿縱要自產，	客戶夥伴，科技平台，基礎網路與組織人才這四個重要資產，
秉持著誠信為本，客戶信賴，創新創價與承諾當責的價值觀朝三大願景共同努邐當問題提到'你會跳哪些舞'時，	秉持著誠信為本，客戶信賴，創新創價與承諾當責的價值觀朝三大願景共同努力當問題提到'你會跳哪些舞'時，
秉持著誠信為本，瞌滬信賴，創釁創價與承諾當責的袈值觀糟三大願景共同努力當問題提到'你會跳鈉些舞'時，	秉持著誠信為本，客戶信賴，創新創價與承諾當責的價值觀朝三大願景共同努力當問題提到'你會跳哪些舞'時，
秉持著誠信為本，嬝戶信賴，創新幢價與懲弱搭責的價值觀朝三大願景共同努力當問題提蹈'旎會跳哪些舞'時，	秉持著誠信為本，客戶信賴，創新創價與承諾當責的價值觀朝三大願景共同努力當問題提到'你會跳哪些舞'時，
秉持著誠信為本，客扈信賴，創新創價與承諾當責的價值觀朝三誕願景共同努力當問題提到'你會跳哪些舞'時，	秉持著誠信為本，客戶信賴，創新創價與承諾當責的價值觀朝三大願景共同努力當問題提到'你會跳哪些舞'時，
秉持著稱薪為本，客戶信賴，創新創價與承碌擋責的價值觀朝三大願景共同努力當問題提到'你會跳哪些捂'時，	秉持著誠信為本，客戶信賴，創新創價與承諾當責的價值觀朝三大願景共同努力當問題提到'你會跳哪些舞'時，
請徊覆'離開地球表面，你是我的花朵，還有最愛的一剪梅，	請回覆'離開地球表面，你是我的花朵，還有最愛的一剪梅，
請回覆'離開地酋表面，你溼我的花朵，還有最愛的一剪梅，	請回覆'離開地球表面，你是我的花朵，還有最愛的一剪梅，
請回覆'狸開地球婊面，你是我的花朵，還有最愛的一剪梅，	請回覆'離開地球表面，你是我的花朵，還有最愛的一剪梅，
請回覆'離開地瓊表面，你是我的花朵，還有最礙的一剪梅，	請回覆'離開地球表面，你是我的花朵，還有最愛的一剪梅，
請回覆'離開地球表函，浬是我的花朵，還有嘴愛的一柬棉，	請回覆'離開地球表面，你是我的花朵，還有最愛的一剪梅，
很多舞蹈我都還再學習'襠問堤提到'我是中荒電信的董虱掌'時，	很多舞蹈我都還在學習'當問題提到'我是中華電信的董事長'時，
很多舞蹈我兜還在學習'當問題提到'我是中華電信的董事長'時，	很多舞蹈我都還在學習'當問題提到'我是中華電信的董事長'時，
很多舞蹈我都還在學習'當問題提到'拙是中華電信的董界長'時，	很多舞蹈我都還在學習'當問題提到'我是中華電信的董事長'時，
很多舞蹈我都霾在學習'當問題提到'我弛中華電信的強事長'時，	很多舞蹈我都還在學習'當問題提到'我是中華電信的董事長'時，
很多舞蹈我都還在學習'蕩問題提禱'我是中華電信的懂釋長'十，	很多舞蹈我都還在學習'當問題提到'我是中華電信的董事長'時，
